glottocode,seg_counts,unseg_counts,unk_counts,total_counts,family
arap1274,48918,48918,0,97836,Algic [algi1248]
gitx1241,153,153,15,321,Tsimshian [tsim1258]
lezg1247,880,880,1,1761,Nakh-Daghestanian [nakh1245]
natu1246,989,989,0,1978,Austronesian [aust1307]
nyan1302,2626,2626,0,5252,Atlantic-Congo [atla1278]
dido1241,4550,4550,1,9101,Nakh-Daghestanian [nakh1245]
uspa1245,10639,10639,0,21278,Mayan [maya1287]
dogr1252,51,51,12,114,Athabaskan-Eyak-Tlingit [atha1245]
weee1241,2,2,0,4,Atlantic-Congo [atla1278]
stan1295,4294,4294,1385,9973,Indo-European [indo1319]
tong1325,239,239,29,507,Austronesian [aust1307]
west2369,780,780,67,1627,Indo-European [indo1319]
iris1253,439,439,22,900,Indo-European [indo1319]
nucl1643,4797,4797,41,9635,Japonic [japo1237]
nucl1301,1612,1612,22,3246,Turkic [turk1311]
astu1246,0,0,22,22,Indo-European [indo1319]
port1283,334,334,45,713,Indo-European [indo1319]
stan1288,1923,1923,629,4475,Indo-European [indo1319]
ital1282,1398,1398,470,3266,Indo-European [indo1319]
braz1246,3,3,109,115,Indo-European [indo1319]
gree1276,87,87,436,610,Indo-European [indo1319]
stan1290,3261,3261,898,7420,Indo-European [indo1319]
chag1248,3,3,92,98,Atlantic-Congo [atla1278]
sout1528,44,44,251,339,Indo-European [indo1319]
amto1250,2,2,0,4,Amto-Musan [amto1249]
mand1415,3942,3942,262,8146,Sino-Tibetan [sino1245]
dutc1256,1565,1565,349,3479,Indo-European [indo1319]
kore1280,3857,3857,1,7715,Koreanic [kore1284]
nucl1310,0,0,3,3,Sino-Tibetan [sino1245]
swed1254,848,848,286,1982,Indo-European [indo1319]
icel1247,52,52,234,338,Indo-European [indo1319]
basq1248,723,723,26,1472,None
bulg1262,32,32,115,179,Indo-European [indo1319]
finn1318,2186,2186,79,4451,Uralic [ural1272]
hind1269,613,613,68,1294,Indo-European [indo1319]
hung1274,1313,1313,110,2736,Uralic [ural1272]
norw1259,1405,1405,1,2811,Indo-European [indo1319]
norw1258,76,76,146,298,Indo-European [indo1319]
mode1248,3,3,31,37,Indo-European [indo1319]
anci1244,285,285,11,581,Afro-Asiatic [afro1255]
siks1238,19,19,0,38,Algic [algi1248]
halk1245,84,84,7,175,Salishan [sali1255]
cypr1249,11,11,98,120,Indo-European [indo1319]
oldj1239,237,237,6,480,Japonic [japo1237]
clas1258,0,0,1,1,Indo-European [indo1319]
pali1273,0,0,1,1,Indo-European [indo1319]
tami1289,82,82,7,171,Dravidian [drav1251]
mala1464,13,13,3,29,Dravidian [drav1251]
akaa1242,1,1,0,2,Eastern Jebel [east2386]
udii1243,247,247,0,494,Nakh-Daghestanian [nakh1245]
oldt1248,1,1,0,2,Dravidian [drav1251]
zapo1437,28,28,0,56,Otomanguean [otom1299]
taca1257,0,0,2,2,Otomanguean [otom1299]
nobi1240,2,2,0,4,Nubian [nubi1251]
czec1258,381,381,202,964,Indo-European [indo1319]
cham1312,218,218,8,444,Austronesian [aust1307]
osse1243,33,33,5,71,Indo-European [indo1319]
poli1260,188,188,251,627,Indo-European [indo1319]
nucl1302,605,605,3,1213,Kartvelian [kart1248]
grea1276,0,0,2,2,Mayan [maya1287]
russ1263,2481,2481,780,5742,Indo-European [indo1319]
nucl1235,70,70,0,140,Indo-European [indo1319]
kang1282,1,1,2,4,Bookkeeping [book1242]
lith1251,48,48,15,111,Indo-European [indo1319]
gunn1250,24,24,20,68,Atlantic-Congo [atla1278]
nucl1305,409,409,0,818,Dravidian [drav1251]
cung1238,0,0,2,2,Atlantic-Congo [atla1278]
maor1246,1,1,72,74,Austronesian [aust1307]
hawa1245,1,1,17,19,Austronesian [aust1307]
bamb1269,0,0,4,4,Mande [mand1469]
uigh1240,32,32,35,99,Turkic [turk1311]
uzbe1247,7,7,6,20,Turkic [turk1311]
telu1262,2,2,2,6,Dravidian [drav1251]
have1240,2,2,1,5,Sino-Tibetan [sino1245]
thai1261,373,373,7,753,Tai-Kadai [taik1256]
yoru1245,156,156,9,321,Atlantic-Congo [atla1278]
moha1258,9,9,1,19,Iroquoian [iroq1247]
mapu1245,156,156,0,312,Araucanian [arau1255]
swah1253,461,461,9,931,Atlantic-Congo [atla1278]
dyir1250,3,3,4,10,Pama-Nyungan [pama1250]
qanj1241,2,2,0,4,Mayan [maya1287]
nepa1254,5,5,0,10,Indo-European [indo1319]
nias1242,50,50,5,105,Austronesian [aust1307]
esto1258,2,2,6,10,Uralic [ural1272]
shon1251,28,28,0,56,Atlantic-Congo [atla1278]
ikal1242,67,67,0,134,Atlantic-Congo [atla1278]
moss1236,43,43,0,86,Atlantic-Congo [atla1278]
taga1270,113,113,107,333,Austronesian [aust1307]
pala1344,41,41,0,82,Austronesian [aust1307]
kash1277,228,228,10,466,Indo-European [indo1319]
nort3264,29,29,0,58,Uralic [ural1272]
fare1244,1,1,0,2,Uralic [ural1272]
surg1248,2,2,0,4,Uralic [ural1272]
camp1261,0,0,4,4,Indo-European [indo1319]
haaa1252,2,2,0,4,Atlantic-Congo [atla1278]
bang1341,56,56,2,114,Atlantic-Congo [atla1278]
naki1238,1,1,0,2,Atlantic-Congo [atla1278]
kips1239,73,73,7,153,Nilotic [nilo1247]
maga1260,6,6,0,12,Indo-European [indo1319]
diml1238,35,35,0,70,Indo-European [indo1319]
chey1247,7,7,0,14,Algic [algi1248]
plai1258,117,117,0,234,Algic [algi1248]
pass1249,14,14,0,28,Algic [algi1248]
roma1327,481,481,110,1072,Indo-European [indo1319]
nucl1460,9,9,4,22,Austronesian [aust1307]
zulu1248,82,82,0,164,Atlantic-Congo [atla1278]
plat1254,947,947,9,1903,Austronesian [aust1307]
puyu1239,130,130,19,279,Austronesian [aust1307]
sund1252,3,3,0,6,Austronesian [aust1307]
bezh1248,4,4,0,8,Nakh-Daghestanian [nakh1245]
coyu1235,7,7,0,14,Totonacan [toto1251]
cari1288,2,2,0,4,Indo-European [indo1319]
germ1281,35,35,7,77,Sign Language [sign1238]
mind1253,21,21,17,59,Sino-Tibetan [sino1245]
stan1289,443,443,78,964,Indo-European [indo1319]
darl1243,2,2,1,5,Pama-Nyungan [pama1250]
swis1247,59,59,5,123,Indo-European [indo1319]
slov1268,151,151,101,403,Indo-European [indo1319]
dani1285,445,445,75,965,Indo-European [indo1319]
indo1316,1250,1250,27,2527,Austronesian [aust1307]
java1254,25,25,3,53,Austronesian [aust1307]
buku1249,148,148,3,299,Atlantic-Congo [atla1278]
swed1236,0,0,2,2,Sign Language [sign1238]
bret1244,57,57,6,120,Indo-European [indo1319]
bela1254,0,0,1,1,Indo-European [indo1319]
midd1343,23,23,14,60,Indo-European [indo1319]
akan1250,301,301,75,677,Atlantic-Congo [atla1278]
halh1238,188,188,1,377,Mongolic-Khitan [mong1349]
sout3123,126,126,0,252,Afro-Asiatic [afro1255]
dink1262,57,57,48,162,Nilotic [nilo1247]
kaqc1270,71,71,6,148,Mayan [maya1287]
ukra1253,46,46,9,101,Indo-European [indo1319]
mace1250,11,11,38,60,Indo-European [indo1319]
oldh1241,31,31,3,65,Indo-European [indo1319]
olde1238,197,197,10,404,Indo-European [indo1319]
late1252,0,0,2,2,Indo-European [indo1319]
kato1244,0,0,1,1,Athabaskan-Eyak-Tlingit [atha1245]
daas1238,0,0,1,1,Afro-Asiatic [afro1255]
vlaa1240,174,174,31,379,Indo-European [indo1319]
neap1235,55,55,32,142,Indo-European [indo1319]
sard1257,2,2,2,6,Indo-European [indo1319]
cors1241,1,1,1,3,Indo-European [indo1319]
faro1244,58,58,28,144,Indo-European [indo1319]
alor1252,11,11,6,28,Austronesian [aust1307]
nucl1417,114,114,33,261,Atlantic-Congo [atla1278]
isla1273,0,0,1,1,Mailuan [mail1249]
bava1246,191,191,21,403,Indo-European [indo1319]
swab1242,1,1,3,5,Indo-European [indo1319]
latv1249,32,32,5,69,Indo-European [indo1319]
chol1282,80,80,2,162,Mayan [maya1287]
nene1249,69,69,2,140,Uralic [ural1272]
huic1243,7,7,0,14,Uto-Aztecan [utoa1244]
kumi1248,35,35,5,75,Cochimi-Yuman [coch1271]
cupe1243,132,132,0,264,Uto-Aztecan [utoa1244]
mpar1238,4,4,0,8,Pama-Nyungan [pama1250]
udmu1245,6,6,0,12,Uralic [ural1272]
bash1264,9,9,0,18,Turkic [turk1311]
amel1241,68,68,0,136,Nuclear Trans New Guinea [nucl1709]
mann1248,0,0,3,3,Mande [mand1469]
moro1292,9,9,1,19,Afro-Asiatic [afro1255]
sout3269,7,7,0,14,Eskimo-Aleut [eski1264]
east2534,440,440,1,881,Eskimo-Aleut [eski1264]
buli1254,62,62,86,210,Atlantic-Congo [atla1278]
tlin1245,0,0,9,9,Athabaskan-Eyak-Tlingit [atha1245]
boro1283,21,21,1,43,Atlantic-Congo [atla1278]
urii1240,1,1,0,2,Nuclear Trans New Guinea [nucl1709]
cant1236,7,7,11,25,Sino-Tibetan [sino1245]
daoo1238,0,0,1,1,Nuclear Trans New Guinea [nucl1709]
lobo1240,0,0,1,1,Atlantic-Congo [atla1278]
kiny1244,192,192,2,386,Atlantic-Congo [atla1278]
sout2739,0,0,2,2,Sino-Tibetan [sino1245]
oldc1244,7,7,5,19,Sino-Tibetan [sino1245]
goth1244,12,12,5,29,Indo-European [indo1319]
para1311,814,814,1,1629,Tupian [tupi1275]
nort3139,45,45,10,100,Afro-Asiatic [afro1255]
malt1254,100,100,6,206,Afro-Asiatic [afro1255]
liby1240,8,8,2,18,Afro-Asiatic [afro1255]
chad1249,40,40,3,83,Afro-Asiatic [afro1255]
alge1239,5,5,0,10,Afro-Asiatic [afro1255]
nezp1238,97,97,0,194,Sahaptian [saha1239]
nand1264,130,130,4,264,Atlantic-Congo [atla1278]
wels1247,26,26,32,84,Indo-European [indo1319]
berb1260,11,11,8,30,Afro-Asiatic [afro1255]
kusa1250,0,0,2,2,Atlantic-Congo [atla1278]
siss1242,0,0,4,4,Atlantic-Congo [atla1278]
defa1248,7,7,0,14,Ijoid [ijoi1239]
yape1248,10,10,1,21,Austronesian [aust1307]
moki1238,0,0,1,1,Austronesian [aust1307]
kpel1252,0,0,11,11,Mande [mand1469]
daur1238,79,79,10,168,Mongolic-Khitan [mong1349]
bela1258,1,1,0,2,Austronesian [aust1307]
alem1243,0,0,1,1,Indo-European [indo1319]
kado1242,4,4,1,9,Sino-Tibetan [sino1245]
hmon1333,7,7,85,99,Hmong-Mien [hmon1336]
kuri1259,52,52,1,105,Atlantic-Congo [atla1278]
luok1236,0,0,1,1,Nilotic [nilo1247]
riop1234,0,0,39,39,Indo-European [indo1319]
huam1248,2,2,0,4,Quechuan [quec1387]
shek1245,3,3,0,6,Dizoid [dizo1235]
udih1248,34,34,2,70,Tungusic [tung1282]
mode1257,2,2,0,4,Indo-European [indo1319]
midd1321,2,2,2,6,Indo-European [indo1319]
dava1250,4,4,1,9,Indo-European [indo1319]
stan1293,181,181,260,622,Indo-European [indo1319]
olds1249,407,407,197,1011,Indo-European [indo1319]
buli1256,18,18,13,49,Austronesian [aust1307]
hoav1238,11,11,1,23,Austronesian [aust1307]
suri1272,0,0,1,1,Indo-European [indo1319]
kaya1319,68,68,4,140,Tangkic [tang1340]
koko1269,21,21,2,44,Austronesian [aust1307]
kwai1243,2,2,0,4,Austronesian [aust1307]
benc1235,6,6,0,12,Ta-Ne-Omotic [gong1255]
kuli1255,2,2,0,4,Pano-Tacanan [pano1259]
seco1241,1,1,0,2,Tucanoan [tuca1253]
avar1256,56,56,0,112,Nakh-Daghestanian [nakh1245]
arch1244,13,13,0,26,Nakh-Daghestanian [nakh1245]
tzel1254,12,12,0,24,Mayan [maya1287]
tzot1259,20,20,3,43,Mayan [maya1287]
okan1243,5,5,0,10,Salishan [sali1255]
spok1245,3,3,0,6,Salishan [sali1255]
colu1241,3,3,0,6,Salishan [sali1255]
mose1249,23,23,0,46,None
shus1248,4,4,0,8,Salishan [sali1255]
thom1243,3,3,0,6,Salishan [sali1255]
tequ1244,1,1,0,2,None
chur1257,0,0,16,16,Indo-European [indo1319]
yupi1267,19,19,2,40,Eskimo-Aleut [eski1264]
lati1261,16,16,25,57,Indo-European [indo1319]
teiw1235,126,126,99,351,Timor-Alor-Pantar [timo1261]
nant1250,2,2,0,4,Arawakan [araw1281]
beng1286,1,1,0,2,Mande [mand1469]
mara1378,73,73,6,152,Indo-European [indo1319]
mong1331,42,42,8,92,Mongolic-Khitan [mong1349]
niue1239,85,85,6,176,Austronesian [aust1307]
fong1242,1,1,0,2,Atlantic-Congo [atla1278]
mani1292,4,4,0,8,Sino-Tibetan [sino1245]
barg1250,65,65,2,132,Mongolic-Khitan [mong1349]
nucl1347,47,47,27,121,Atlantic-Congo [atla1278]
sinh1246,33,33,1,67,Indo-European [indo1319]
friu1240,19,19,2,40,Indo-European [indo1319]
yuca1254,670,670,16,1356,Mayan [maya1287]
hitt1242,37,37,21,95,Indo-European [indo1319]
nort2690,105,105,0,210,Turkic [turk1311]
tima1241,32,32,10,74,Katla-Tima [katl1246]
alba1267,14,14,22,50,Indo-European [indo1319]
lako1247,19,19,14,52,Siouan [siou1252]
sici1248,21,21,4,46,Indo-European [indo1319]
nons1235,0,0,2,2,Indo-European [indo1319]
mexi1248,0,0,6,6,Indo-European [indo1319]
luxe1241,0,0,7,7,Indo-European [indo1319]
rhin1244,1,1,10,12,Indo-European [indo1319]
penn1240,84,84,4,172,Indo-European [indo1319]
afri1274,331,331,29,691,Indo-European [indo1319]
east2295,76,76,22,174,Indo-European [indo1319]
atin1240,74,74,0,148,Kartvelian [kart1248]
chuk1273,179,179,0,358,Chukotko-Kamchatkan [chuk1271]
sout2961,2,2,0,4,Kiowa-Tanoan [kiow1265]
stin1234,9,9,0,18,Austronesian [aust1307]
mari1278,1,1,0,2,Uralic [ural1272]
hopi1249,25,25,0,50,Uto-Aztecan [utoa1244]
motl1237,1,1,4,6,Austronesian [aust1307]
bisl1239,3,3,4,10,Indo-European [indo1319]
some1244,1,1,0,2,Fasu [fasu1242]
guja1252,15,15,5,35,Indo-European [indo1319]
deni1241,0,0,2,2,Arawan [araw1282]
samo1305,276,276,11,563,Austronesian [aust1307]
toke1240,0,0,21,21,Austronesian [aust1307]
nama1264,99,99,33,231,Khoe-Kwadi [khoe1240]
aghe1239,25,25,2,52,Atlantic-Congo [atla1278]
huay1240,18,18,0,36,Quechuan [quec1387]
shiw1234,1,1,1,3,Atlantic-Congo [atla1278]
yang1286,0,0,1,1,Tai-Kadai [taik1256]
kaza1248,15,15,2,32,Turkic [turk1311]
stan1318,240,240,0,480,Afro-Asiatic [afro1255]
fior1235,4,4,0,8,Indo-European [indo1319]
dann1241,33,33,23,89,Mande [mand1469]
turo1239,29,29,15,73,Afro-Asiatic [afro1255]
hebr1245,748,748,18,1514,Afro-Asiatic [afro1255]
russ1264,63,63,2,128,Mongolic-Khitan [mong1349]
daww1239,4,4,17,25,Naduhup [nada1235]
ticu1245,0,0,21,21,Ticuna-Yuri [ticu1244]
eder1237,0,0,1,1,Nuclear Trans New Guinea [nucl1709]
warl1254,663,663,1,1327,Pama-Nyungan [pama1250]
domi1242,0,0,1,1,Indo-European [indo1319]
fris1239,7,7,8,22,Indo-European [indo1319]
otta1242,38,38,0,76,Algic [algi1248]
mesk1242,53,53,0,106,Algic [algi1248]
chip1241,2,2,0,4,Algic [algi1248]
minn1241,193,193,0,386,Sino-Tibetan [sino1245]
pite1240,287,287,37,611,Uralic [ural1272]
chec1245,13,13,0,26,Nakh-Daghestanian [nakh1245]
oldf1239,145,145,6,296,Indo-European [indo1319]
oira1263,8,8,0,16,Timor-Alor-Pantar [timo1261]
mang1381,9,9,0,18,Mangarrayi-Maran [mang1423]
mull1237,2,2,0,4,Northern Daly [nort1547]
wapp1239,24,24,2,50,Yuki-Wappo [yuki1242]
ipai1240,1,1,0,2,Cochimi-Yuman [coch1271]
tenn1246,17,17,0,34,Surmic [surm1244]
vall1252,6,6,0,12,Maiduan [maid1262]
savo1255,21,21,8,50,None
moha1256,25,25,0,50,Cochimi-Yuman [coch1271]
mari1440,4,4,2,10,Cochimi-Yuman [coch1271]
wala1270,4,4,0,8,Cochimi-Yuman [coch1271]
hava1249,6,6,1,13,Cochimi-Yuman [coch1271]
bora1271,14,14,1,29,Afro-Asiatic [afro1255]
east2652,23,23,0,46,Afro-Asiatic [afro1255]
gamo1243,13,13,0,26,Ta-Ne-Omotic [gong1255]
alab1254,11,11,5,27,Afro-Asiatic [afro1255]
zays1236,2,2,1,5,Ta-Ne-Omotic [gong1255]
wola1242,12,12,1,25,Ta-Ne-Omotic [gong1255]
arbo1245,10,10,2,22,Afro-Asiatic [afro1255]
murl1244,7,7,3,17,Surmic [surm1244]
maaa1253,14,14,0,28,Austroasiatic [aust1305]
nand1266,10,10,2,22,Nilotic [nilo1247]
turk1308,44,44,0,88,Nilotic [nilo1247]
dato1239,5,5,3,13,Nilotic [nilo1247]
ajie1238,6,6,10,22,Austronesian [aust1307]
yava1252,9,9,1,19,Cochimi-Yuman [coch1271]
wask1241,24,24,7,55,Nuclear Trans New Guinea [nucl1709]
kaki1249,1,1,0,2,None
yawu1244,10,10,0,20,Nyulnyulan [nyul1248]
naba1256,7,7,0,14,Nuclear Trans New Guinea [nucl1709]
eipo1242,2,2,0,4,Nuclear Trans New Guinea [nucl1709]
coco1261,2,2,3,7,Cochimi-Yuman [coch1271]
pari1256,2,2,0,4,Nilotic [nilo1247]
kild1236,7,7,7,21,Uralic [ural1272]
komi1268,11,11,1,23,Uralic [ural1272]
kalm1244,3,3,3,9,Mongolic-Khitan [mong1349]
lowe1385,3,3,0,6,Indo-European [indo1319]
oroc1248,10,10,0,20,Tungusic [tung1282]
sali1295,17,17,0,34,Austronesian [aust1307]
nort2641,71,71,1,143,Indo-European [indo1319]
endo1242,2,2,2,6,Nilotic [nilo1247]
nort2671,28,28,15,71,Uralic [ural1272]
mina1268,0,0,3,3,Austronesian [aust1307]
lahu1253,0,0,3,3,Sino-Tibetan [sino1245]
sout2750,5,5,0,10,Yukaghir [yuka1259]
chuv1255,17,17,0,34,Turkic [turk1311]
east2335,0,0,2,2,Turkic [turk1311]
bolg1250,2,2,1,5,Turkic [turk1311]
east2328,1,1,0,2,Uralic [ural1272]
oldr1238,10,10,0,20,Indo-European [indo1319]
amha1245,79,79,1,159,Afro-Asiatic [afro1255]
wari1268,6,6,0,12,Chapacuran [chap1271]
kaer1234,6,6,6,18,Timor-Alor-Pantar [timo1261]
abui1241,101,101,37,239,Timor-Alor-Pantar [timo1261]
blag1240,14,14,6,34,Timor-Alor-Pantar [timo1261]
kelo1247,10,10,2,22,Timor-Alor-Pantar [timo1261]
lamm1241,34,34,40,108,Timor-Alor-Pantar [timo1261]
adan1251,14,14,26,54,Timor-Alor-Pantar [timo1261]
sawi1256,6,6,2,14,Timor-Alor-Pantar [timo1261]
buna1278,3,3,4,10,Timor-Alor-Pantar [timo1261]
tobe1252,18,18,0,36,North Halmahera [nort2923]
fore1270,21,21,1,43,Nuclear Trans New Guinea [nucl1709]
nucl1622,5,5,0,10,Anim [anim1240]
enga1252,7,7,0,14,Nuclear Trans New Guinea [nucl1709]
mian1256,2,2,2,6,Nuclear Trans New Guinea [nucl1709]
nucl1630,21,21,0,42,Koiarian [koia1260]
inan1242,4,4,0,8,None
wers1238,28,28,20,76,Timor-Alor-Pantar [timo1261]
kama1365,62,62,40,164,Timor-Alor-Pantar [timo1261]
misk1235,2,2,0,4,Misumalpan [misu1242]
gugu1255,9,9,1,19,Pama-Nyungan [pama1250]
urdu1245,280,280,0,560,Indo-European [indo1319]
cher1273,5,5,4,14,Iroquoian [iroq1247]
darg1241,564,564,19,1147,Nakh-Daghestanian [nakh1245]
mauw1238,1963,1963,170,4096,Nuclear Trans New Guinea [nucl1709]
east2303,0,0,3,3,Indo-European [indo1319]
orsa1234,0,0,7,7,Indo-European [indo1319]
elfd1234,18,18,44,80,Indo-European [indo1319]
soll1234,1,1,11,13,Indo-European [indo1319]
arch1246,0,0,6,6,Indo-European [indo1319]
paas1238,0,0,4,4,Atlantic-Congo [atla1278]
gonj1241,1,1,1,3,Atlantic-Congo [atla1278]
vagl1239,0,0,1,1,Atlantic-Congo [atla1278]
wali1263,0,0,3,3,Atlantic-Congo [atla1278]
grus1239,0,0,1,1,Atlantic-Congo [atla1278]
haus1257,1497,1497,9,3003,Afro-Asiatic [afro1255]
kase1253,0,0,2,2,Atlantic-Congo [atla1278]
kwaa1262,6,6,4,16,Atlantic-Congo [atla1278]
gura1261,0,0,3,3,Atlantic-Congo [atla1278]
arab1395,166,166,37,369,Afro-Asiatic [afro1255]
aust1307,5,5,9,19,None
papu1250,115,115,1340,1570,Austronesian [aust1307]
sarm1242,2,2,23,27,Austronesian [aust1307]
nucl1632,0,0,1,1,Sentanic [sent1261]
nort2828,0,0,2,2,Austronesian [aust1307]
biak1248,0,0,6,6,Austronesian [aust1307]
ambo1255,0,0,1,1,Austronesian [aust1307]
dobo1244,0,0,1,1,Austronesian [aust1307]
sril1245,0,0,1,1,Austronesian [aust1307]
mala1481,6,6,17,29,Austronesian [aust1307]
isir1237,0,0,2,2,Greater Kwerba [kwer1242]
saba1263,0,0,1,1,Austronesian [aust1307]
wakd1237,0,0,2,2,Austronesian [aust1307]
bone1255,1,1,1,3,Tor-Orya [toro1256]
jama1262,1,1,71,73,Indo-European [indo1319]
gull1243,0,0,1,1,Indo-European [indo1319]
sran1240,37,37,24,98,Indo-European [indo1319]
creo1235,4,4,15,23,Indo-European [indo1319]
sara1340,0,0,1,1,Indo-European [indo1319]
berb1259,4,4,8,16,Indo-European [indo1319]
phal1254,826,826,66,1718,Indo-European [indo1319]
krio1253,4,4,12,20,Indo-European [indo1319]
fern1234,95,95,1343,1533,Indo-European [indo1319]
ewee1241,119,119,1,239,Atlantic-Congo [atla1278]
efik1245,2,2,5,9,Atlantic-Congo [atla1278]
yauy1235,37,37,0,74,Quechuan [quec1387]
warl1255,1,1,0,2,Pama-Nyungan [pama1250]
geee1239,0,0,2,2,Hmong-Mien [hmon1336]
mori1278,2,2,12,16,Indo-European [indo1319]
hait1244,84,84,37,205,Indo-European [indo1319]
mala1533,0,0,1,1,Indo-European [indo1319]
saot1239,3,3,0,6,Indo-European [indo1319]
sese1246,16,16,3,35,Indo-European [indo1319]
ndyu1242,6,6,2,14,Indo-European [indo1319]
yuch1247,8,8,0,16,None
mand1446,12,12,5,29,Siouan [siou1252]
bilo1248,8,8,2,18,Siouan [siou1252]
chic1270,66,66,0,132,Muskogean [musk1252]
ofoo1242,2,2,0,4,Siouan [siou1252]
atak1252,2,2,0,4,None
chit1248,1,1,1,3,None
choc1276,184,184,0,368,Muskogean [musk1252]
natc1249,2,2,0,4,None
tuni1252,1,1,0,2,None
kans1243,3,3,3,9,Siouan [siou1252]
iowa1246,5,5,0,10,Siouan [siou1252]
iowa1245,8,8,4,20,Siouan [siou1252]
hida1246,25,25,5,55,Siouan [siou1252]
hoch1243,127,127,19,273,Siouan [siou1252]
assi1247,13,13,2,28,Siouan [siou1252]
crow1244,7,7,5,19,Siouan [siou1252]
omah1248,1,1,11,13,Siouan [siou1252]
omah1247,53,53,13,119,Siouan [siou1252]
osag1243,4,4,0,8,Siouan [siou1252]
ngit1239,8,8,1,17,Central Sudanic [cent2225]
sout2969,0,0,1,1,Uto-Aztecan [utoa1244]
beng1280,147,147,3,297,Indo-European [indo1319]
assa1263,8,8,2,18,Indo-European [indo1319]
imon1245,10,10,0,20,Border [bord1247]
gand1255,85,85,27,197,Atlantic-Congo [atla1278]
laoo1244,2,2,13,17,Tai-Kadai [taik1256]
sali1255,8,8,0,16,None
siwu1238,1,1,0,2,Atlantic-Congo [atla1278]
ikkk1242,45,45,151,241,Kuliak [kuli1252]
yong1288,135,135,63,333,Sino-Tibetan [sino1245]
mand1469,0,0,3,3,None
laze1238,1,1,0,2,Sino-Tibetan [sino1245]
tibe1272,35,35,2,72,Sino-Tibetan [sino1245]
nais1236,0,0,1,1,Sino-Tibetan [sino1245]
shix1238,0,0,2,2,Sino-Tibetan [sino1245]
sini1245,0,0,3,3,Sino-Tibetan [sino1245]
east2346,1,1,0,2,Sino-Tibetan [sino1245]
naxi1245,2,2,1,5,Sino-Tibetan [sino1245]
roma1334,5,5,16,26,Indo-European [indo1319]
sout2807,97,97,3,197,Atlantic-Congo [atla1278]
here1253,5,5,3,13,Atlantic-Congo [atla1278]
lugu1238,18,18,0,36,Atlantic-Congo [atla1278]
maas1239,3,3,0,6,Atlantic-Congo [atla1278]
molo1266,780,780,251,1811,Afro-Asiatic [afro1255]
muya1243,3,3,1,7,Afro-Asiatic [afro1255]
vame1236,1,1,0,2,Afro-Asiatic [afro1255]
mama1272,2,2,0,4,Atlantic-Congo [atla1278]
dalo1238,1,1,3,5,Kru [krua1234]
krua1234,1,1,1,3,None
gbad1242,4,4,0,8,Kru [krua1234]
vata1239,0,0,2,2,Kru [krua1234]
tief1242,2,2,6,10,Atlantic-Congo [atla1278]
gaaa1244,32,32,15,79,Atlantic-Congo [atla1278]
tsoo1241,1,1,2,4,Atlantic-Congo [atla1278]
maay1238,12,12,0,24,Afro-Asiatic [afro1255]
pula1263,129,129,0,258,Atlantic-Congo [atla1278]
sere1260,67,67,11,145,Atlantic-Congo [atla1278]
ibib1240,60,60,2,122,Atlantic-Congo [atla1278]
akwa1248,2,2,0,4,Atlantic-Congo [atla1278]
ling1263,1,1,0,2,Atlantic-Congo [atla1278]
sene1264,2,2,0,4,Iroquoian [iroq1247]
zagh1240,11,11,5,27,Saharan [saha1256]
buna1275,14,14,0,28,Bunaban [buna1274]
tama1332,0,0,1,1,Tamaic [tama1329]
kiku1240,29,29,0,58,Atlantic-Congo [atla1278]
wira1264,2,2,0,4,Tupian [tupi1275]
dand1239,0,0,1,1,Atlantic-Congo [atla1278]
kobi1242,1,1,0,2,Austronesian [aust1307]
fant1241,18,18,0,36,Atlantic-Congo [atla1278]
yaaa1241,3,3,0,6,Atlantic-Congo [atla1278]
yaww1238,2,2,0,4,Sino-Tibetan [sino1245]
dege1246,3,3,35,41,Atlantic-Congo [atla1278]
logo1258,136,136,1,273,Atlantic-Congo [atla1278]
kaon1241,3,3,0,6,Atlantic-Congo [atla1278]
idak1244,3,3,0,6,Atlantic-Congo [atla1278]
sout2808,77,77,0,154,Atlantic-Congo [atla1278]
sira1266,10,10,0,20,Atlantic-Congo [atla1278]
nyan1308,322,322,1,645,Atlantic-Congo [atla1278]
tswa1253,41,41,0,82,Atlantic-Congo [atla1278]
makh1264,18,18,0,36,Atlantic-Congo [atla1278]
mako1251,11,11,1,23,Atlantic-Congo [atla1278]
rong1268,14,14,0,28,Atlantic-Congo [atla1278]
chan1318,4,4,0,8,Atlantic-Congo [atla1278]
egyp1245,2,2,0,4,Afro-Asiatic [afro1255]
jita1239,4,4,2,10,Atlantic-Congo [atla1278]
digo1243,13,13,3,29,Atlantic-Congo [atla1278]
fuli1240,1,1,3,5,Atlantic-Congo [atla1278]
mwan1247,1,1,3,5,Atlantic-Congo [atla1278]
bena1259,1,1,1,3,Atlantic-Congo [atla1278]
kabw1241,0,0,1,1,Atlantic-Congo [atla1278]
suba1252,3,3,0,6,Atlantic-Congo [atla1278]
kway1241,1,1,1,3,Atlantic-Congo [atla1278]
lopi1242,9,9,0,18,Nilotic [nilo1247]
soma1255,42,42,3,87,Afro-Asiatic [afro1255]
bamb1262,75,75,1,151,Blue Nile Mao [maoo1243]
hozo1236,1,1,0,2,Blue Nile Mao [maoo1243]
urho1239,5,5,0,10,Atlantic-Congo [atla1278]
ndii1240,1,1,0,2,Atlantic-Congo [atla1278]
ocea1241,4,4,4,12,Austronesian [aust1307]
taro1265,1,1,0,2,Atlantic-Congo [atla1278]
taro1263,1,1,0,2,Atlantic-Congo [atla1278]
bium1280,6,6,2,14,Afro-Asiatic [afro1255]
weno1238,0,0,1,1,Kru [krua1234]
bong1285,14,14,3,31,Central Sudanic [cent2225]
kain1275,2,2,3,7,Atlantic-Congo [atla1278]
guro1248,2,2,0,4,Mande [mand1469]
sigi1234,0,0,1,1,Afro-Asiatic [afro1255]
kula1277,0,0,4,4,Atlantic-Congo [atla1278]
cang1245,0,0,2,2,Atlantic-Congo [atla1278]
gbay1288,1,1,2,4,Kresh-Aja [kres1240]
gada1257,1,1,1,3,Atlantic-Congo [atla1278]
polc1243,1,1,0,2,Afro-Asiatic [afro1255]
bant1294,2,2,3,7,Atlantic-Congo [atla1278]
poto1254,0,0,1,1,Atlantic-Congo [atla1278]
ngas1240,1,1,1,3,Afro-Asiatic [afro1255]
yiwo1237,0,0,1,1,Afro-Asiatic [afro1255]
lend1245,1,1,1,3,Central Sudanic [cent2225]
mang1396,3,3,1,7,Central Sudanic [cent2225]
gbay1292,2,2,0,4,Kresh-Aja [kres1240]
mang1394,4,4,0,8,Central Sudanic [cent2225]
jowu1238,1,1,0,2,Mande [mand1469]
rapa1244,3,3,1329,1335,Austronesian [aust1307]
tuva1244,0,0,6,6,Austronesian [aust1307]
tahi1242,6,6,85,97,Austronesian [aust1307]
rapa1245,0,0,2,2,Austronesian [aust1307]
mang1401,0,0,5,5,Austronesian [aust1307]
pile1238,0,0,2,2,Austronesian [aust1307]
nuku1260,0,0,5,5,Austronesian [aust1307]
raro1241,0,0,2,2,Austronesian [aust1307]
taku1257,0,0,2,2,Austronesian [aust1307]
tiko1237,0,0,3,3,Austronesian [aust1307]
marq1246,0,0,2,2,Austronesian [aust1307]
lauu1247,0,0,3,3,Austronesian [aust1307]
tach1250,6,6,0,12,Afro-Asiatic [afro1255]
toor1238,3,3,0,6,Atlantic-Congo [atla1278]
ndal1241,25,25,0,50,Atlantic-Congo [atla1278]
umbu1257,4,4,0,8,Atlantic-Congo [atla1278]
kala1384,30,30,0,60,Atlantic-Congo [atla1278]
yeyi1239,14,14,0,28,Atlantic-Congo [atla1278]
sukw1242,7,7,0,14,Atlantic-Congo [atla1278]
tote1238,8,8,0,16,Atlantic-Congo [atla1278]
ngon1268,2,2,0,4,Atlantic-Congo [atla1278]
kham1286,7,7,0,14,Sino-Tibetan [sino1245]
sans1272,2,2,0,4,Atlantic-Congo [atla1278]
mali1279,3,3,0,6,Atlantic-Congo [atla1278]
vwan1235,1,1,0,2,Atlantic-Congo [atla1278]
kala1399,21,21,2,44,Eskimo-Aleut [eski1264]
teng1267,5,5,12,22,Austronesian [aust1307]
tuyu1244,26,26,0,52,Tucanoan [tuca1253]
turk1303,4,4,0,8,Turkic [turk1311]
kima1244,57,57,13,127,Austronesian [aust1307]
bare1279,20,20,0,40,Afro-Asiatic [afro1255]
tokp1240,33,33,15,81,Indo-European [indo1319]
bilu1245,0,0,2,2,None
maya1287,5,5,0,10,None
sans1269,57,57,24,138,Indo-European [indo1319]
hixk1239,0,0,1,1,Cariban [cari1283]
pipi1250,1,1,0,2,Uto-Aztecan [utoa1244]
tsho1240,1,1,0,2,Sino-Tibetan [sino1245]
japh1234,3501,3501,29,7031,Sino-Tibetan [sino1245]
jiar1240,5,5,0,10,Sino-Tibetan [sino1245]
soni1259,6,6,5,17,Mande [mand1469]
kita1249,2,2,6,10,Mande [mand1469]
mand1436,1,1,0,2,Mande [mand1469]
limb1268,14,14,93,121,Atlantic-Congo [atla1278]
noon1243,0,0,5,5,Atlantic-Congo [atla1278]
medu1238,1,1,28,30,Atlantic-Congo [atla1278]
momo1242,0,0,2,2,Atlantic-Congo [atla1278]
isuf1235,1,1,1,3,Atlantic-Congo [atla1278]
akoo1248,0,0,4,4,Atlantic-Congo [atla1278]
bamu1253,0,0,1,1,Atlantic-Congo [atla1278]
mund1327,1,1,2,4,Atlantic-Congo [atla1278]
fumm1238,0,0,2,2,Bookkeeping [book1242]
nupo1239,0,0,3,3,Atlantic-Congo [atla1278]
abar1238,0,0,3,3,Atlantic-Congo [atla1278]
indo1321,6,6,5,17,Indo-European [indo1319]
nhan1238,0,0,1,1,Pama-Nyungan [pama1250]
awad1243,2,2,2,6,Indo-European [indo1319]
oldm1244,1,1,1,3,Indo-European [indo1319]
braj1242,0,0,4,4,Indo-European [indo1319]
bund1253,0,0,2,2,Indo-European [indo1319]
laca1243,13,13,1,27,Mayan [maya1287]
itza1241,41,41,1,83,Mayan [maya1287]
mopa1243,39,39,17,95,Mayan [maya1287]
slav1255,8,8,19,35,Indo-European [indo1319]
anci1242,125,125,52,302,Indo-European [indo1319]
capp1239,52,52,0,104,Indo-European [indo1319]
inui1246,5,5,0,10,Eskimo-Aleut [eski1264]
aleu1260,18,18,1,37,Eskimo-Aleut [eski1264]
west2793,1,1,0,2,Indo-European [indo1319]
uppe1398,3,3,19,25,Indo-European [indo1319]
macu1259,3,3,2,8,Cariban [cari1283]
cent1989,2,2,2,6,Austroasiatic [aust1305]
chat1268,7,7,34,48,Otomanguean [otom1299]
mati1253,540,540,39,1119,Cariban [cari1283]
maru1252,95,95,2,192,Pano-Tacanan [pano1259]
trum1247,11,11,41,63,None
guan1269,294,294,3,591,Tucanoan [tuca1253]
hupd1244,141,141,1,283,Naduhup [nada1235]
saku1239,46,46,6,98,Tupian [tupi1275]
suya1243,88,88,10,186,Nuclear-Macro-Je [nucl1710]
kwaz1243,53,53,2,108,None
aika1237,152,152,0,304,None
suru1262,65,65,1,131,Tupian [tupi1275]
urub1250,46,46,4,96,Tupian [tupi1275]
djin1251,128,128,0,256,Mirndi [mirn1241]
warr1258,6,6,0,12,Nyulnyulan [nyul1248]
agua1253,14,14,0,28,Chicham [jiva1245]
bats1242,18,18,0,36,Nakh-Daghestanian [nakh1245]
mait1250,4,4,0,8,Indo-European [indo1319]
lite1247,2,2,0,4,Indo-European [indo1319]
copt1239,92,92,0,184,Afro-Asiatic [afro1255]
olde1242,1,1,0,2,Afro-Asiatic [afro1255]
late1256,4,4,0,8,Afro-Asiatic [afro1255]
sahi1241,7,7,0,14,Afro-Asiatic [afro1255]
lyco1237,19,19,0,38,Afro-Asiatic [afro1255]
kxoe1243,11,11,5,27,Khoe-Kwadi [khoe1240]
dama1270,6,6,0,12,Khoe-Kwadi [khoe1240]
shua1254,5,5,0,10,Khoe-Kwadi [khoe1240]
tsix1234,6,6,2,14,Khoe-Kwadi [khoe1240]
shek1243,0,0,1,1,Indo-European [indo1319]
kuma1273,0,0,5,5,Indo-European [indo1319]
bhoj1244,4,4,2,10,Indo-European [indo1319]
hary1238,1,1,2,4,Indo-European [indo1319]
avam1236,21,21,0,42,Uralic [ural1272]
fore1265,22,22,0,44,Uralic [ural1272]
sumi1235,27,27,2,56,Sino-Tibetan [sino1245]
khez1235,1,1,1,3,Sino-Tibetan [sino1245]
maoo1244,3,3,0,6,Atlantic-Congo [atla1278]
sout2674,0,0,8,8,Uralic [ural1272]
lule1254,0,0,1,1,Uralic [ural1272]
skol1241,0,0,2,2,Uralic [ural1272]
sout2959,0,0,3,3,Athabaskan-Eyak-Tlingit [atha1245]
nyul1248,2,2,0,4,None
urar1246,2,2,0,4,None
yele1255,0,0,1,1,None
saba1268,280,280,0,560,Nambiquaran [namb1299]
indo1320,0,0,4,4,Indo-European [indo1319]
ural1272,3,3,0,6,None
aust1305,0,0,2,2,None
guiq1238,2,2,0,4,Sino-Tibetan [sino1245]
indo1319,4,4,4,12,None
tsez1239,10,10,0,20,Nakh-Daghestanian [nakh1245]
khoe1241,1,1,0,2,Khoe-Kwadi [khoe1240]
qian1264,2,2,0,4,Sino-Tibetan [sino1245]
araw1282,2,2,2,6,None
kusu1250,0,0,2,2,None
timo1261,3,3,1,7,None
tung1282,3,3,0,6,None
mong1329,2,2,0,4,Mongolic-Khitan [mong1349]
barb1265,4,4,0,8,None
ainu1252,7,7,22,36,None
nivk1234,19,19,0,38,None
alut1245,9,9,0,18,Chukotko-Kamchatkan [chuk1271]
kory1246,4,4,0,8,Chukotko-Kamchatkan [chuk1271]
kere1280,3,3,0,6,Chukotko-Kamchatkan [chuk1271]
itel1242,7,7,0,14,Chukotko-Kamchatkan [chuk1271]
kjac1234,0,0,2,2,Pidgin [pidg1258]
taim1252,1,1,1,3,Pidgin [pidg1258]
saka1298,0,0,2,2,Indo-European [indo1319]
sogd1245,0,0,3,3,Indo-European [indo1319]
sari1246,2,2,5,9,Indo-European [indo1319]
tokh1243,0,0,2,2,Indo-European [indo1319]
tokh1242,0,0,3,3,Indo-European [indo1319]
yila1234,0,0,4,4,Japonic [japo1237]
atay1247,169,169,3,341,Austronesian [aust1307]
uraa1244,2,2,3,7,Sino-Tibetan [sino1245]
sout2954,7,7,0,14,Japonic [japo1237]
kuni1268,2,2,1,5,Japonic [japo1237]
shur1243,11,11,0,22,Japonic [japo1237]
cent2126,7,7,1,15,Japonic [japo1237]
miya1259,16,16,5,37,Japonic [japo1237]
hate1238,1,1,1,3,Japonic [japo1237]
hato1238,3,3,3,9,Japonic [japo1237]
yona1241,3,3,1,7,Japonic [japo1237]
sona1243,3,3,2,8,Japonic [japo1237]
midd1372,3,3,0,6,Koreanic [kore1284]
midd1351,3,3,0,6,Mongolic-Khitan [mong1349]
kham1281,3,3,2,8,Mongolic-Khitan [mong1349]
ordo1245,2,2,0,4,Mongolic-Khitan [mong1349]
kalm1243,0,0,1,1,Mongolic-Khitan [mong1349]
east2337,1,1,0,2,Mongolic-Khitan [mong1349]
bona1250,7,7,2,16,Mongolic-Khitan [mong1349]
kang1281,6,6,1,13,Mongolic-Khitan [mong1349]
dong1285,10,10,2,22,Mongolic-Khitan [mong1349]
huzh1238,8,8,0,16,Mongolic-Khitan [mong1349]
minh1238,5,5,3,13,Mongolic-Khitan [mong1349]
dung1253,3,3,0,6,Sino-Tibetan [sino1245]
wutu1241,9,9,0,18,Sino-Tibetan [sino1245]
tang1373,2,2,1,5,Sino-Tibetan [sino1245]
gang1272,2,2,0,4,Sino-Tibetan [sino1245]
tibe1276,7,7,5,19,Sino-Tibetan [sino1245]
amdo1237,2,2,2,6,Sino-Tibetan [sino1245]
qian1263,3,3,4,10,Sino-Tibetan [sino1245]
baim1244,1,1,1,3,Sino-Tibetan [sino1245]
even1259,59,59,1,119,Tungusic [tung1282]
even1260,16,16,0,32,Tungusic [tung1282]
oroq1238,19,19,3,41,Tungusic [tung1282]
solo1263,9,9,2,20,Tungusic [tung1282]
nana1257,9,9,1,19,Tungusic [tung1282]
negi1245,19,19,0,38,Tungusic [tung1282]
kile1243,6,6,2,14,Tungusic [tung1282]
jurc1239,2,2,0,4,Tungusic [tung1282]
orok1265,48,48,4,100,Tungusic [tung1282]
manc1252,22,22,5,49,Tungusic [tung1282]
sibe1252,25,25,11,61,Tungusic [tung1282]
bala1299,1,1,2,4,Sino-Tibetan [sino1245]
sala1264,7,7,0,14,Turkic [turk1311]
tata1255,23,23,2,48,Turkic [turk1311]
kirg1245,6,6,2,14,Turkic [turk1311]
ainu1251,2,2,0,4,Turkic [turk1311]
ilit1241,2,2,0,4,Turkic [turk1311]
tuvi1240,12,12,1,25,Turkic [turk1311]
tofa1248,1,1,1,3,Turkic [turk1311]
khak1248,9,9,0,18,Turkic [turk1311]
shor1247,6,6,1,13,Turkic [turk1311]
nort2686,4,4,0,8,Turkic [turk1311]
chul1246,4,4,0,8,Turkic [turk1311]
yaku1245,465,465,1,931,Turkic [turk1311]
dolg1241,2,2,1,5,Turkic [turk1311]
ngan1291,8,8,0,16,Uralic [ural1272]
enet1250,3,3,0,6,Uralic [ural1272]
nene1251,12,12,2,26,Uralic [ural1272]
selk1253,2,2,0,4,Uralic [ural1272]
kama1351,0,0,3,3,Uralic [ural1272]
kett1243,33,33,3,69,Yeniseian [yeni1252]
yugh1239,2,2,2,6,Yeniseian [yeni1252]
kott1239,0,0,1,1,Yeniseian [yeni1252]
kiow1264,0,0,2,2,Athabaskan-Eyak-Tlingit [atha1245]
eyak1241,0,0,2,2,Athabaskan-Eyak-Tlingit [atha1245]
nava1243,189,189,1,379,Athabaskan-Eyak-Tlingit [atha1245]
yuka1259,19,19,3,41,None
coro1247,1,1,0,2,Quechuan [quec1387]
germ1287,1,1,46,48,Indo-European [indo1319]
abar1239,0,0,1,1,Atlantic-Congo [atla1278]
resh1242,0,0,1,1,Atlantic-Congo [atla1278]
ngwo1241,1,1,4,6,Atlantic-Congo [atla1278]
taki1251,6,6,0,12,Austronesian [aust1307]
bunu1267,20,20,3,43,Austronesian [aust1307]
mala1479,35,35,10,80,Austronesian [aust1307]
vera1241,13,13,22,48,Austronesian [aust1307]
bali1278,219,219,25,463,Austronesian [aust1307]
stan1306,1,1,0,2,Austronesian [aust1307]
kula1284,1,1,0,2,Austronesian [aust1307]
bala1315,2,2,1,5,Austronesian [aust1307]
mara1404,2,2,0,4,Austronesian [aust1307]
sumb1241,3,3,45,51,Austronesian [aust1307]
bima1247,10,10,2,22,Austronesian [aust1307]
taro1264,150,150,21,321,Austronesian [aust1307]
teru1237,3,3,1,7,Austronesian [aust1307]
sira1267,0,0,1,1,Austronesian [aust1307]
toto1304,0,0,2,2,Austronesian [aust1307]
waim1252,3,3,5,11,Austronesian [aust1307]
wara1294,307,307,553,1167,Yam [more1255]
bili1250,0,0,3,3,Pama-Nyungan [pama1250]
nenn1238,2,2,6,10,Yam [more1255]
aram1253,1,1,3,5,Yam [more1255]
kunj1246,1,1,1,3,Yam [more1255]
anta1254,6,6,5,17,Yam [more1255]
kala1397,18,18,4,40,Nuclear Trans New Guinea [nucl1709]
ngka1235,1,1,2,4,Yam [more1255]
tond1250,3,3,0,6,Yam [more1255]
nama1265,1,1,0,2,Khoe-Kwadi [khoe1240]
suki1245,1,1,0,2,Suki-Gogodala [suki1244]
woii1237,0,0,1,1,Austronesian [aust1307]
alam1246,14,14,0,28,Sepik [sepi1257]
yima1243,98,98,1,197,Lower Sepik [lowe1423]
paam1238,9,9,0,18,Austronesian [aust1307]
tuka1247,1,1,0,2,Austronesian [aust1307]
maib1239,15,15,0,30,None
noct1238,17,17,0,34,Sino-Tibetan [sino1245]
lard1243,6,6,0,12,Tangkic [tang1340]
panj1256,52,52,0,104,Indo-European [indo1319]
kurd1259,11,11,1,23,Indo-European [indo1319]
arom1237,15,15,0,30,Indo-European [indo1319]
mart1255,22,22,0,44,Pama-Nyungan [pama1250]
sout2857,6,6,0,12,Austronesian [aust1307]
siro1249,5,5,2,12,Nuclear Trans New Guinea [nucl1709]
cavi1250,3,3,2,8,Pano-Tacanan [pano1259]
koro1312,41,41,12,94,Nuclear Trans New Guinea [nucl1709]
aime1238,66,66,15,147,Bosavi [bosa1245]
mafe1237,35,35,0,70,Austronesian [aust1307]
maee1241,0,0,2,2,Austronesian [aust1307]
sunw1242,2,2,0,4,Sino-Tibetan [sino1245]
wamb1259,12,12,1,25,Nuclear Trans New Guinea [nucl1709]
balu1257,3,3,0,6,Austronesian [aust1307]
sauk1252,5,5,0,10,Nuclear Trans New Guinea [nucl1709]
onoo1246,6,6,0,12,Nuclear Trans New Guinea [nucl1709]
timb1251,0,0,2,2,Nuclear Trans New Guinea [nucl1709]
tari1256,35,35,0,70,Arawakan [araw1281]
sout2940,2,2,0,4,Nuclear Trans New Guinea [nucl1709]
muru1274,3,3,0,6,Huitotoan [huit1251]
mach1267,12,12,4,28,Arawakan [araw1281]
head1238,1,1,0,2,Nuclear Trans New Guinea [nucl1709]
hunz1247,32,32,0,64,Nakh-Daghestanian [nakh1245]
hinu1240,12,12,0,24,Nakh-Daghestanian [nakh1245]
khva1239,15,15,0,30,Nakh-Daghestanian [nakh1245]
agul1244,2,2,0,4,Nakh-Daghestanian [nakh1245]
mand1473,3,3,0,6,Nuclear Trans New Guinea [nucl1709]
siee1239,3,3,0,6,Austronesian [aust1307]
kabi1260,1,1,0,2,Pama-Nyungan [pama1250]
coos1249,6,6,0,12,Coosan [coos1248]
waya1269,1,1,0,2,Cariban [cari1283]
gali1262,11,11,0,22,Cariban [cari1283]
utoa1244,11,11,2,24,None
nupe1254,87,87,1,175,Atlantic-Congo [atla1278]
sino1245,3,3,4,10,None
yace1238,0,0,1,1,Atlantic-Congo [atla1278]
nuuu1241,1,1,4,6,Tuu [tuuu1241]
lukp1238,4,4,2,10,Atlantic-Congo [atla1278]
iraq1241,6,6,1,13,Afro-Asiatic [afro1255]
cent2050,8,8,5,21,Saharan [saha1256]
utee1244,4,4,0,8,Uto-Aztecan [utoa1244]
loni1238,0,0,5,5,Austronesian [aust1307]
sout2765,0,0,1,1,Pama-Nyungan [pama1250]
kwom1262,0,0,1,1,Sepik [sepi1257]
viet1252,242,242,1,485,Austroasiatic [aust1305]
nucl1328,2,2,0,4,Mirndi [mirn1241]
mayo1261,1,1,0,2,Atlantic-Congo [atla1278]
toab1237,1,1,0,2,Austronesian [aust1307]
jams1239,1,1,2,4,Dogon [dogo1299]
yagu1244,15,15,0,30,Peba-Yagua [peba1241]
donn1239,5,5,0,10,Dogon [dogo1299]
wann1242,1,1,0,2,Mande [mand1469]
awtu1239,5,5,0,10,Sepik [sepi1257]
mamm1241,3,3,0,6,Mayan [maya1287]
tama1365,1,1,0,2,Afro-Asiatic [afro1255]
lolo1267,0,0,4,4,Sino-Tibetan [sino1245]
ingu1240,13,13,5,31,Nakh-Daghestanian [nakh1245]
chum1261,4,4,0,8,Atlantic-Congo [atla1278]
lele1264,1,1,0,2,Atlantic-Congo [atla1278]
uduk1239,25,25,15,65,Koman [koma1264]
valm1241,75,75,0,150,Nuclear Torricelli [nucl1708]
torr1259,3,3,0,6,Nuclear Torricelli [nucl1708]
hali1245,15,15,0,30,Anim [anim1240]
sepi1257,5,5,0,10,None
mekk1240,10,10,0,20,Nuclear Trans New Guinea [nucl1709]
roto1249,5,5,0,10,North Bougainville [nort2933]
burm1264,3,3,0,6,None
nort2933,2,2,0,4,None
usho1238,4,4,0,8,Indo-European [indo1319]
khow1242,4,4,0,8,Indo-European [indo1319]
dame1241,0,0,3,3,Indo-European [indo1319]
indu1241,0,0,2,2,Indo-European [indo1319]
kala1373,1,1,2,4,Indo-European [indo1319]
bate1261,2,2,0,4,Indo-European [indo1319]
gawa1247,3,3,0,6,Indo-European [indo1319]
kala1372,1,1,0,2,Indo-European [indo1319]
kohi1248,4,4,0,8,Indo-European [indo1319]
buru1296,20,20,0,40,None
chir1284,2,2,0,4,Nakh-Daghestanian [nakh1245]
mege1234,215,215,0,430,Nakh-Daghestanian [nakh1245]
bagv1239,8,8,0,16,Nakh-Daghestanian [nakh1245]
tagw1240,18,18,11,47,Atlantic-Congo [atla1278]
nafa1256,25,25,1,51,Atlantic-Congo [atla1278]
hehe1240,50,50,0,100,Atlantic-Congo [atla1278]
nyam1276,2,2,0,4,Atlantic-Congo [atla1278]
abee1242,1,1,2,4,Atlantic-Congo [atla1278]
genn1243,3,3,16,22,Atlantic-Congo [atla1278]
nort2626,0,0,2,2,Indo-European [indo1319]
cuev1239,0,0,3,3,Otomanguean [otom1299]
taba1266,44,44,2,90,Mayan [maya1287]
amar1273,179,179,77,435,Austronesian [aust1307]
beja1238,21,21,0,42,Afro-Asiatic [afro1255]
assy1241,3,3,2,8,Afro-Asiatic [afro1255]
safa1245,1,1,0,2,Afro-Asiatic [afro1255]
aram1259,2,2,0,4,Afro-Asiatic [afro1255]
clas1252,2,2,0,4,Afro-Asiatic [afro1255]
nort3142,1,1,1,3,Afro-Asiatic [afro1255]
egyp1253,35,35,0,70,Afro-Asiatic [afro1255]
nubi1253,4,4,3,11,Afro-Asiatic [afro1255]
bari1284,10,10,1,21,Nilotic [nilo1247]
acol1236,2,2,1,5,Nilotic [nilo1247]
jurm1239,0,0,1,1,Central Sudanic [cent2225]
zand1248,0,0,1,1,Atlantic-Congo [atla1278]
pidg1248,1,1,3,5,Pidgin [pidg1258]
bath1244,5,5,0,10,Afro-Asiatic [afro1255]
mehr1241,3,3,1,7,Afro-Asiatic [afro1255]
awji1241,3,3,0,6,Afro-Asiatic [afro1255]
siwi1239,56,56,8,120,Afro-Asiatic [afro1255]
cent1972,26,26,0,52,Indo-European [indo1319]
anti1246,2,2,0,4,Indo-European [indo1319]
nabl1238,7,7,1,15,Indo-European [indo1319]
kaby1243,1,1,1,3,Afro-Asiatic [afro1255]
tago1246,1,1,0,2,Rashad [rash1249]
koal1240,1,1,0,2,Heibanic [heib1242]
taji1245,4,4,1,9,Indo-European [indo1319]
midd1317,0,0,3,3,Indo-European [indo1319]
mana1295,2,2,0,4,Austronesian [aust1307]
kumz1235,1,1,0,2,Indo-European [indo1319]
tuar1240,0,0,1,1,Afro-Asiatic [afro1255]
doma1258,3,3,0,6,Indo-European [indo1319]
igoo1238,0,0,2,2,Atlantic-Congo [atla1278]
nalc1240,1,1,0,2,Nuclear Trans New Guinea [nucl1709]
mich1243,3,3,0,6,Algic [algi1248]
namb1299,1,1,0,2,None
texm1235,1,1,0,2,Otomanguean [otom1299]
pali1279,2,2,0,4,Arawakan [araw1281]
pnar1238,1,1,3,5,Austroasiatic [aust1305]
mund1330,3,3,0,6,Tupian [tupi1275]
sant1410,8,8,0,16,Austroasiatic [aust1305]
malt1248,0,0,2,2,Dravidian [drav1251]
uban1244,1,1,0,2,Atlantic-Congo [atla1278]
otom1299,1,1,0,2,None
anim1240,2,2,0,4,None
oksa1245,2,2,0,4,Nuclear Trans New Guinea [nucl1709]
algo1257,1,1,0,2,Algic [algi1248]
khas1268,0,0,3,3,Austroasiatic [aust1305]
nilo1247,1,1,0,2,None
mixt1427,0,0,1,1,Otomanguean [otom1299]
bora1262,2,2,0,4,None
sout2772,1,1,0,2,None
balt1257,0,0,3,3,Indo-European [indo1319]
lezg1248,1,1,0,2,Nakh-Daghestanian [nakh1245]
koma1264,1,1,0,2,None
taaa1242,2,2,2,6,Tuu [tuuu1241]
nakh1245,1,1,0,2,None
iroq1247,2,2,0,4,None
maun1240,1,1,0,2,Iwaidjan Proper [iwai1246]
cush1243,8,8,2,18,Afro-Asiatic [afro1255]
sout2789,161,161,67,389,Atlantic-Congo [atla1278]
tehu1242,1,1,0,2,Chonan [chon1288]
sanz1248,1878,1878,27,3783,Nakh-Daghestanian [nakh1245]
cusc1236,366,366,0,732,Quechuan [quec1387]
ghod1238,2,2,0,4,Nakh-Daghestanian [nakh1245]
luva1239,2,2,0,4,Atlantic-Congo [atla1278]
gbee1241,0,0,1,1,Atlantic-Congo [atla1278]
lele1276,0,0,1,1,Afro-Asiatic [afro1255]
pash1269,2,2,1,5,Indo-European [indo1319]
onei1249,16,16,0,32,Iroquoian [iroq1247]
coas1300,3,3,0,6,Tsimshian [tsim1258]
moro1285,1,1,0,2,Heibanic [heib1242]
bata1289,28,28,1,57,Austronesian [aust1307]
eeee1240,0,0,2,2,Tai-Kadai [taik1256]
khen1241,4,4,0,8,Sino-Tibetan [sino1245]
toto1306,71,71,1,143,Barbacoan [barb1265]
nort2973,2,2,0,4,Quechuan [quec1387]
murr1259,4,4,0,8,Southern Daly [sout2772]
atti1240,0,0,34,34,Indo-European [indo1319]
dori1248,0,0,13,13,Indo-European [indo1319]
umbr1253,0,0,3,3,Indo-European [indo1319]
achi1257,73,73,0,146,Austronesian [aust1307]
tune1261,0,0,2,2,Atlantic-Congo [atla1278]
lang1320,2,2,0,4,Atlantic-Congo [atla1278]
luba1249,3,3,0,6,Atlantic-Congo [atla1278]
basa1284,1,1,3,5,Atlantic-Congo [atla1278]
bemb1255,5,5,0,10,Atlantic-Congo [atla1278]
fonn1241,49,49,7,105,Atlantic-Congo [atla1278]
lavu1241,2,2,0,4,None
tian1238,0,0,2,2,Sino-Tibetan [sino1245]
kumb1268,6,6,0,12,Pama-Nyungan [pama1250]
kuma1276,15,15,4,34,Austronesian [aust1307]
kava1241,132,132,2,266,Austronesian [aust1307]
amis1246,18,18,0,36,Austronesian [aust1307]
scot1245,56,56,67,179,Indo-European [indo1319]
mikm1235,4,4,0,8,Algic [algi1248]
yueh1236,2,2,0,4,Sino-Tibetan [sino1245]
sout2991,21,21,0,42,Quechuan [quec1387]
gali1258,16,16,0,32,Indo-European [indo1319]
oldi1245,35,35,1,71,Indo-European [indo1319]
raja1256,1,1,0,2,Indo-European [indo1319]
occi1239,0,0,2,2,Indo-European [indo1319]
gayo1244,1,1,0,2,Austronesian [aust1307]
samb1305,0,0,1,1,Atlantic-Congo [atla1278]
tali1258,1,1,0,2,Atlantic-Congo [atla1278]
tigr1270,6,6,2,14,Afro-Asiatic [afro1255]
paum1247,8,8,0,16,Arawan [araw1282]
west2721,3,3,0,6,Afro-Asiatic [afro1255]
kimb1241,3,3,1,7,Atlantic-Congo [atla1278]
rund1242,33,33,1,67,Atlantic-Congo [atla1278]
gunw1252,26,26,0,52,Gunwinyguan [gunw1250]
belh1239,192,192,0,384,Sino-Tibetan [sino1245]
oldp1257,0,0,2,2,Indo-European [indo1319]
pana1305,7,7,0,14,Uto-Aztecan [utoa1244]
chum1264,2,2,1,5,Bookkeeping [book1242]
bari1286,1,1,0,2,Austronesian [aust1307]
usan1239,19,19,0,38,Nuclear Trans New Guinea [nucl1709]
epen1239,3,3,0,6,Chocoan [choc1280]
noon1242,9,9,0,18,Atlantic-Congo [atla1278]
yura1255,3,3,0,6,None
mana1298,1,1,0,2,Ndu [nduu1242]
kora1295,2,2,0,4,Nuclear Trans New Guinea [nucl1709]
stra1246,1,1,1,3,Salishan [sali1255]
nort3160,1,1,0,2,Indo-European [indo1319]
dadi1249,11,11,15,37,Atlantic-Congo [atla1278]
avat1244,68,68,0,136,Atlantic-Congo [atla1278]
seek1238,1,1,3,5,Mande [mand1469]
gyel1242,1093,1093,252,2438,Atlantic-Congo [atla1278]
xhos1239,1,1,0,2,Atlantic-Congo [atla1278]
konk1269,57,57,13,127,Atlantic-Congo [atla1278]
gabo1234,14,14,10,38,Kru [krua1234]
mosi1247,3,3,3,9,Nilotic [nilo1247]
mand1478,3,3,0,6,Atlantic-Congo [atla1278]
nugu1241,2,2,0,4,Pama-Nyungan [pama1250]
sala1268,1,1,0,2,Atlantic-Congo [atla1278]
chuw1238,2,2,0,4,Atlantic-Congo [atla1278]
soga1242,1,1,0,2,Atlantic-Congo [atla1278]
ikiz1238,1,1,0,2,Atlantic-Congo [atla1278]
kisi1243,1,1,0,2,Atlantic-Congo [atla1278]
makw1236,3,3,0,6,Atlantic-Congo [atla1278]
nath1238,3,3,0,6,Atlantic-Congo [atla1278]
kagu1239,1,1,0,2,Atlantic-Congo [atla1278]
nden1248,1,1,0,2,Atlantic-Congo [atla1278]
kami1254,2,2,0,4,Sino-Tibetan [sino1245]
duma1253,1,1,1,3,Atlantic-Congo [atla1278]
ndum1239,0,0,2,2,Atlantic-Congo [atla1278]
mber1257,0,0,6,6,Atlantic-Congo [atla1278]
tumb1250,2,2,0,4,Atlantic-Congo [atla1278]
luba1252,2,2,0,4,Austronesian [aust1307]
ombo1238,2,2,0,4,Atlantic-Congo [atla1278]
nucl1379,1,1,0,2,Atlantic-Congo [atla1278]
yaoo1241,2,2,0,4,Atlantic-Congo [atla1278]
matu1259,1,1,0,2,Atlantic-Congo [atla1278]
tete1250,1,1,2,4,Atlantic-Congo [atla1278]
ngun1272,1,1,1,3,Atlantic-Congo [atla1278]
tien1242,1,1,1,3,Atlantic-Congo [atla1278]
beem1239,2,2,0,4,Atlantic-Congo [atla1278]
ding1239,1,1,1,3,Atlantic-Congo [atla1278]
sett1235,1,1,1,3,Pidgin [pidg1258]
paaa1242,0,0,3,3,Afro-Asiatic [afro1255]
gida1247,3,3,0,6,Afro-Asiatic [afro1255]
mina1273,1,1,2,4,Nuclear Trans New Guinea [nucl1709]
hdii1240,1,1,1,3,Afro-Asiatic [afro1255]
wand1278,3,3,0,6,Afro-Asiatic [afro1255]
gude1246,10,10,2,22,Afro-Asiatic [afro1255]
ngiz1242,1,1,2,4,Afro-Asiatic [afro1255]
buwa1243,2,2,1,5,Afro-Asiatic [afro1255]
nucl1683,0,0,1,1,Afro-Asiatic [afro1255]
siva1239,1,1,5,7,Indo-European [indo1319]
kupi1238,5,5,0,10,Indo-European [indo1319]
pahl1241,1,1,3,5,Indo-European [indo1319]
oldp1255,0,0,1,1,Bookkeeping [book1242]
gila1241,2,2,0,4,Indo-European [indo1319]
oriy1255,4,4,0,8,Indo-European [indo1319]
taly1247,19,19,0,38,Indo-European [indo1319]
west2354,0,0,4,4,Indo-European [indo1319]
erzy1239,1,1,0,2,Uralic [ural1272]
nyan1301,7,7,0,14,Pama-Nyungan [pama1250]
muru1266,6,6,0,12,Pama-Nyungan [pama1250]
koka1244,4,4,0,8,Pama-Nyungan [pama1250]
aran1263,5,5,0,10,Pama-Nyungan [pama1250]
yank1247,29,29,0,58,Pama-Nyungan [pama1250]
saam1281,2,2,1,5,Uralic [ural1272]
ahte1237,1,1,0,2,Athabaskan-Eyak-Tlingit [atha1245]
babi1235,3,3,0,6,Athabaskan-Eyak-Tlingit [atha1245]
nort2942,5,5,1,11,Athabaskan-Eyak-Tlingit [atha1245]
wint1259,10,10,1,21,Wintuan [wint1258]
hara1270,0,0,1,1,Afro-Asiatic [afro1255]
surs1245,63,63,1292,1418,Indo-European [indo1319]
suts1235,0,0,3,3,Indo-European [indo1319]
kuan1248,10,10,2,22,Austronesian [aust1307]
band1358,2,2,0,4,Pama-Nyungan [pama1250]
chim1301,2,2,0,4,None
awac1239,27,27,0,54,Barbacoan [barb1265]
cree1270,2,2,0,4,Muskogean [musk1252]
kons1243,2,2,0,4,Afro-Asiatic [afro1255]
bora1263,3,3,0,6,Boran [bora1262]
khmu1256,1,1,1,3,Austroasiatic [aust1305]
ghom1257,2,2,0,4,Afro-Asiatic [afro1255]
pila1245,2,2,0,4,Guaicuruan [guai1249]
dier1241,37,37,0,74,Pama-Nyungan [pama1250]
kute1249,181,181,0,362,None
yapu1240,4,4,0,8,Nuclear Torricelli [nucl1708]
dhim1246,4,4,0,8,Sino-Tibetan [sino1245]
esee1248,4,4,0,8,Pano-Tacanan [pano1259]
lumu1239,4,4,0,8,Narrow Talodi [narr1279]
maja1242,5,5,0,10,Surmic [surm1244]
tern1247,3,3,1,7,North Halmahera [nort2923]
maka1316,3,3,1,7,Timor-Alor-Pantar [timo1261]
yine1238,4,4,0,8,Arawakan [araw1281]
turk1304,1,1,0,2,Turkic [turk1311]
noga1249,7,7,0,14,Turkic [turk1311]
osse1245,2,2,0,4,Indo-European [indo1319]
sout2972,701,701,78,1480,Uto-Aztecan [utoa1244]
yaqu1251,507,507,0,1014,Uto-Aztecan [utoa1244]
cora1259,1,1,0,2,Uto-Aztecan [utoa1244]
huar1255,5,5,2,12,Uto-Aztecan [utoa1244]
lowl1265,10,10,0,20,Uto-Aztecan [utoa1244]
numi1242,2,2,0,4,Uto-Aztecan [utoa1244]
ruul1235,277,277,3,557,Atlantic-Congo [atla1278]
olds1252,0,0,34,34,Indo-European [indo1319]
stan1279,2,2,35,39,Indo-European [indo1319]
lowg1239,0,0,1,1,Indo-European [indo1319]
dale1238,0,0,3,3,Indo-European [indo1319]
miya1266,2,2,0,4,Afro-Asiatic [afro1255]
ulwa1239,2,2,0,4,Misumalpan [misu1242]
adyg1241,22,22,0,44,Abkhaz-Adyge [abkh1242]
kalk1246,21,21,0,42,Pama-Nyungan [pama1250]
awng1244,6,6,0,12,Afro-Asiatic [afro1255]
bili1260,1,1,0,2,Afro-Asiatic [afro1255]
kara1499,388,388,565,1341,West Bomberai [west2604]
gese1240,0,0,1,1,Austronesian [aust1307]
koas1236,13,13,0,26,Muskogean [musk1252]
fwee1238,1386,1386,3,2775,Atlantic-Congo [atla1278]
lamu1253,6,6,0,12,Tungusic [tung1282]
kore1284,1,1,0,2,None
arma1243,0,0,1,1,Tungusic [tung1282]
ussu1239,1,1,0,2,Tungusic [tung1282]
lali1241,1,1,0,2,Tungusic [tung1282]
sout2731,1,1,0,2,Sino-Tibetan [sino1245]
peri1253,8,8,4,20,Mongolic-Khitan [mong1349]
beta1252,1,1,0,2,Austronesian [aust1307]
rumu1243,1,1,0,2,Turama-Kikori [tura1263]
kani1286,1,1,0,2,Nuclear Trans New Guinea [nucl1709]
guru1261,4,4,0,8,Sino-Tibetan [sino1245]
wels1246,3,3,0,6,Indo-European [indo1319]
nucl1276,6,6,0,12,Indo-European [indo1319]
roma1326,124,124,0,248,Indo-European [indo1319]
izie1238,1,1,0,2,Atlantic-Congo [atla1278]
gang1267,13,13,0,26,Tangkic [tang1340]
megl1237,37,37,0,74,Indo-European [indo1319]
ngem1255,1,1,0,2,Atlantic-Congo [atla1278]
basq1249,14,14,0,28,Basque [basq1248]
abaz1241,73,73,0,146,Abkhaz-Adyge [abkh1242]
,0,0,0,0,
tang1334,3,3,0,6,Sino-Tibetan [sino1245]
ango1258,1,1,0,2,Indo-European [indo1319]
sora1254,2,2,0,4,Austroasiatic [aust1305]
thao1240,6,6,0,12,Austronesian [aust1307]
cent2131,8,8,0,16,Uto-Aztecan [utoa1244]
cash1254,3,3,0,6,Pano-Tacanan [pano1259]
dehu1237,1,1,0,2,Austronesian [aust1307]
nort2722,624,624,0,1248,Sino-Tibetan [sino1245]
jehh1245,1,1,0,2,Austroasiatic [aust1305]
vute1244,4,4,0,8,Atlantic-Congo [atla1278]
kwam1252,4,4,0,8,Austronesian [aust1307]
nucl1634,439,439,0,878,Sko [skoo1245]
siar1238,484,484,0,968,Austronesian [aust1307]
dima1251,1,1,0,2,Sino-Tibetan [sino1245]
mezq1235,15,15,0,30,Otomanguean [otom1299]
sala1269,1,1,0,2,Austronesian [aust1307]
term1237,4,4,0,8,Austronesian [aust1307]
logu1236,31,31,0,62,Indo-European [indo1319]
nort2938,4,4,0,8,Haida [haid1248]
uruu1244,16,16,0,32,Uru-Chipaya [uruc1242]
rovi1238,6,6,0,12,Austronesian [aust1307]
ravu1237,1,1,0,2,Dravidian [drav1251]
guia1246,6,6,0,12,Indo-European [indo1319]
rama1270,3,3,0,6,Chibchan [chib1249]
guah1255,2,2,0,4,Guahiboan [guah1252]
tuka1249,124,124,0,248,Austronesian [aust1307]
kono1268,1,1,0,2,Mande [mand1469]
caml1239,1,1,0,2,Sino-Tibetan [sino1245]
sout2741,2,2,0,4,Tai-Kadai [taik1256]
rawa1265,9,9,0,18,Sino-Tibetan [sino1245]
komi1269,12,12,0,24,Uralic [ural1272]
ward1246,3,3,0,6,Yangmanic [yang1287]
east2538,8,8,0,16,Uto-Aztecan [utoa1244]
ware1253,1,1,0,2,Austronesian [aust1307]
goli1247,9,9,0,18,Nuclear Trans New Guinea [nucl1709]
pare1266,1,1,0,2,Austroasiatic [aust1305]
garr1260,32,32,0,64,None
nort2907,23,23,0,46,Nuclear Torricelli [nucl1708]
high1276,4,4,0,8,Mixe-Zoque [mixe1284]
palu1252,39,39,0,78,Austronesian [aust1307]
godi1239,1,1,0,2,Kru [krua1234]
kenu1236,7,7,0,14,Nubian [nubi1251]
achu1247,2,2,0,4,Palaihnihan [pala1350]
tido1248,3,3,0,6,North Halmahera [nort2923]
alya1239,6,6,0,12,Pama-Nyungan [pama1250]
seba1251,31,31,0,62,Afro-Asiatic [afro1255]
deor1238,1,1,0,2,Sino-Tibetan [sino1245]
daga1275,7,7,0,14,Dagan [daga1274]
croa1245,36,36,0,72,Indo-European [indo1319]
cham1318,8,8,0,16,Arawakan [araw1281]
cent2117,3,3,0,6,Nuclear Trans New Guinea [nucl1709]
djee1236,7,7,0,14,Maningrida [mani1293]
isth1244,7,7,0,14,Otomanguean [otom1299]
saek1240,1,1,0,2,Tai-Kadai [taik1256]
jeri1242,1,1,0,2,Mande [mand1469]
haru1245,4,4,0,8,Piawi [piaw1238]
atti1239,3,3,0,6,Atlantic-Congo [atla1278]
nige1253,48,48,0,96,Atlantic-Congo [atla1278]
sout2697,1,1,0,2,Turkic [turk1311]
desa1247,3,3,0,6,Tucanoan [tuca1253]
seri1257,3,3,0,6,None
tuba1278,4,4,0,8,Uto-Aztecan [utoa1244]
main1267,2,2,0,4,Indo-European [indo1319]
lari1255,11,11,0,22,Austronesian [aust1307]
amba1265,5,5,0,10,Austronesian [aust1307]
tzot1264,46,46,0,92,Bookkeeping [book1242]
tauy1241,8,8,0,16,Nuclear Trans New Guinea [nucl1709]
ambo1250,1,1,0,2,Austronesian [aust1307]
kair1263,1,1,0,2,Austronesian [aust1307]
kayt1238,1,1,0,2,Pama-Nyungan [pama1250]
kitu1246,3,3,0,6,Atlantic-Congo [atla1278]
guad1242,2,2,0,4,Indo-European [indo1319]
ying1247,5,5,0,10,Pama-Nyungan [pama1250]
remb1249,3,3,0,6,Gunwinyguan [gunw1250]
para1315,1,1,0,2,Nuclear-Macro-Je [nucl1710]
kach1280,12,12,0,24,Sino-Tibetan [sino1245]
paiw1248,251,251,0,502,Austronesian [aust1307]
gras1249,7,7,0,14,Koiarian [koia1260]
nort2723,5,5,0,10,Sino-Tibetan [sino1245]
east2426,2,2,0,4,Mande [mand1469]
uppe1438,8,8,0,16,Athabaskan-Eyak-Tlingit [atha1245]
waga1260,4,4,0,8,Pama-Nyungan [pama1250]
pang1290,3,3,0,6,Austronesian [aust1307]
papi1253,40,40,0,80,Indo-European [indo1319]
boko1266,6,6,0,12,Mande [mand1469]
piem1238,6,6,0,12,Indo-European [indo1319]
swat1243,4,4,0,8,Atlantic-Congo [atla1278]
sars1236,4,4,0,8,Athabaskan-Eyak-Tlingit [atha1245]
cayu1261,5,5,0,10,Iroquoian [iroq1247]
tawa1275,2,2,0,4,Austronesian [aust1307]
east2542,18,18,0,36,Algic [algi1248]
dhan1270,2,2,0,4,Pama-Nyungan [pama1250]
bini1246,290,290,0,580,Atlantic-Congo [atla1278]
lako1244,11,11,0,22,Kru [krua1234]
gito1238,2,2,0,4,Atlantic-Congo [atla1278]
tong1318,3,3,0,6,Atlantic-Congo [atla1278]
casu1237,1,1,0,2,Nuclear Trans New Guinea [nucl1709]
taba1263,2,2,0,4,North Halmahera [nort2923]
anua1242,1,1,0,2,Nilotic [nilo1247]
guer1241,1,1,0,2,Uto-Aztecan [utoa1244]
kwak1269,8,8,0,16,Wakashan [waka1280]
mali1284,1,1,0,2,Baining [bain1263]
bahi1254,1,1,0,2,Sepik [sepi1257]
capa1241,16,16,0,32,Pano-Tacanan [pano1259]
klam1254,1,1,0,2,None
kura1250,5,5,0,10,Mande [mand1469]
byan1241,6,6,0,12,Sino-Tibetan [sino1245]
kate1253,7,7,0,14,Nuclear Trans New Guinea [nucl1709]
nsen1242,183,183,0,366,Atlantic-Congo [atla1278]
ende1246,8,8,0,16,Austronesian [aust1307]
sara1326,12,12,0,24,Austronesian [aust1307]
cent2138,11,11,0,22,Pomoan [pomo1273]
onon1246,6,6,0,12,Iroquoian [iroq1247]
ambu1247,6,6,0,12,Ndu [nduu1242]
tzut1248,7,7,0,14,Mayan [maya1287]
serb1264,765,768,0,1533,Indo-European [indo1319]
adze1241,2,2,0,4,Bookkeeping [book1242]
awap1236,4,4,0,8,Nuclear Trans New Guinea [nucl1709]
anei1239,2,2,0,4,Austronesian [aust1307]
filo1235,1,1,0,2,Totonacan [toto1251]
dhar1247,1,1,0,2,Pama-Nyungan [pama1250]
shos1248,3,3,0,6,Uto-Aztecan [utoa1244]
dhiv1236,16,16,0,32,Indo-European [indo1319]
west2863,48,48,0,96,Bookkeeping [book1242]
sout2985,4,4,0,8,Miwok-Costanoan [miwo1274]
uppe1395,6,6,0,12,Indo-European [indo1319]
guri1247,46,46,0,92,Pama-Nyungan [pama1250]
tusc1257,9,9,0,18,Iroquoian [iroq1247]
west2631,3,3,0,6,Tarascan [tara1323]
siri1273,9,9,0,18,Tupian [tupi1275]
east2443,17,17,0,34,Austronesian [aust1307]
sain1246,3,3,0,6,Indo-European [indo1319]
pohn1238,6,6,0,12,Austronesian [aust1307]
waka1274,2,2,0,4,Pama-Nyungan [pama1250]
park1239,1,1,0,2,Afro-Asiatic [afro1255]
pulu1242,2,2,0,4,Austronesian [aust1307]
koyu1237,6,6,0,12,Athabaskan-Eyak-Tlingit [atha1245]
west2635,297,297,0,594,Mayan [maya1287]
sout2728,6,6,0,12,Sino-Tibetan [sino1245]
klao1243,2,2,0,4,Kru [krua1234]
ital1275,2,2,0,4,Sign Language [sign1238]
nort2959,3,3,0,6,Uto-Aztecan [utoa1244]
wang1291,25,25,0,50,Pama-Nyungan [pama1250]
nung1283,4,4,0,8,Tai-Kadai [taik1256]
band1355,1,1,0,2,Austronesian [aust1307]
east2342,5,5,0,10,Sino-Tibetan [sino1245]
waim1255,4,4,0,8,Tucanoan [tuca1253]
kara1465,7,7,0,14,Turkic [turk1311]
nort2966,4,4,0,8,Pomoan [pomo1273]
jaka1246,52,52,0,104,Bookkeeping [book1242]
west2618,8,8,0,16,Eskimo-Aleut [eski1264]
cane1242,6,6,0,12,Nuclear-Macro-Je [nucl1710]
yaki1237,8,8,0,16,Sahaptian [saha1239]
sang1328,1,1,0,2,Atlantic-Congo [atla1278]
kokb1239,4,4,0,8,Sino-Tibetan [sino1245]
sout2978,75,75,0,150,Algic [algi1248]
pich1237,6,6,0,12,Arawakan [araw1281]
mwag1236,30,30,0,60,Afro-Asiatic [afro1255]
siyi1240,37,37,0,74,Sino-Tibetan [sino1245]
suen1241,1,1,0,2,Nuclear Trans New Guinea [nucl1709]
hual1241,33,33,0,66,Quechuan [quec1387]
nort2646,84,84,0,168,Indo-European [indo1319]
arhu1242,8,8,0,16,Chibchan [chib1249]
lama1277,2,2,0,4,Austronesian [aust1307]
tsak1249,58,58,0,116,Nakh-Daghestanian [nakh1245]
high1242,1,1,0,2,Tequistlatecan [tequ1244]
popt1235,49,49,0,98,Mayan [maya1287]
bank1258,3,3,0,6,Mande [mand1469]
cebu1242,27,27,0,54,Austronesian [aust1307]
didi1258,1,1,0,2,Surmic [surm1244]
ajyi1238,1,1,0,2,Arawakan [araw1281]
tupi1273,5,5,0,10,Tupian [tupi1275]
tsou1248,183,183,0,366,Austronesian [aust1307]
soch1239,3,3,0,6,Otomanguean [otom1299]
akka1240,3,3,0,6,Afro-Asiatic [afro1255]
susu1250,2,2,0,4,Mande [mand1469]
west1510,3,3,0,6,Algic [algi1248]
humb1243,1,1,0,2,Songhay [song1307]
pitc1234,3,3,0,6,Indo-European [indo1319]
nort2943,3,3,0,6,Eskimo-Aleut [eski1264]
wals1238,36,36,0,72,Indo-European [indo1319]
pado1242,3,3,0,6,Austronesian [aust1307]
nyul1247,1,1,0,2,Nyulnyulan [nyul1248]
kekc1242,7,7,0,14,Mayan [maya1287]
bagi1246,31,31,0,62,Central Sudanic [cent2225]
east2516,10,10,0,20,Nuclear Trans New Guinea [nucl1709]
west2632,1,1,0,2,Keresan [kere1287]
egyp1246,1,1,0,2,Afro-Asiatic [afro1255]
kili1267,2,2,0,4,Austronesian [aust1307]
wuch1236,11,11,0,22,Sino-Tibetan [sino1245]
nyaw1247,2,2,0,4,Pama-Nyungan [pama1250]
chic1272,1,1,0,2,Otomanguean [otom1299]
tang1336,39,39,0,78,Sino-Tibetan [sino1245]
waig1243,1,1,0,2,Indo-European [indo1319]
oldn1244,90,90,0,180,Indo-European [indo1319]
bwek1238,19,19,0,38,Sino-Tibetan [sino1245]
maon1238,5,5,0,10,Sino-Tibetan [sino1245]
nort2961,14,14,0,28,Algic [algi1248]
argo1244,5,5,0,10,Afro-Asiatic [afro1255]
bara1380,1,1,0,2,Tucanoan [tuca1253]
tuni1259,15,15,0,30,Afro-Asiatic [afro1255]
oldg1234,8,8,0,16,Kartvelian [kart1248]
aros1241,1,1,0,2,Austronesian [aust1307]
tsat1238,16,16,0,32,Austronesian [aust1307]
chip1261,2,2,0,4,Athabaskan-Eyak-Tlingit [atha1245]
apat1240,3,3,0,6,Sino-Tibetan [sino1245]
jama1261,1,1,0,2,Arawan [araw1282]
chag1247,1,1,0,2,Turkic [turk1311]
apur1254,8,8,0,16,Arawakan [araw1281]
thar1283,31,31,0,62,Atlantic-Congo [atla1278]
imba1240,47,47,0,94,Quechuan [quec1387]
west2594,7,7,0,14,Nuclear Trans New Guinea [nucl1709]
hwan1240,1,1,0,2,Afro-Asiatic [afro1255]
mach1266,27,27,0,54,Atlantic-Congo [atla1278]
thul1246,2,2,0,4,Sino-Tibetan [sino1245]
tinp1237,1,1,0,2,Austronesian [aust1307]
ande1247,2,2,0,4,Pama-Nyungan [pama1250]
vend1245,38,38,0,76,Atlantic-Congo [atla1278]
cent2136,30,30,0,60,Algic [algi1248]
naas1242,4,4,0,8,South Bougainville [sout2948]
utes1238,23,23,0,46,Uto-Aztecan [utoa1244]
yagn1238,1,1,0,2,Indo-European [indo1319]
goka1239,4,4,0,8,Atlantic-Congo [atla1278]
nija1242,4,4,0,8,Bookkeeping [book1242]
noot1239,170,170,0,340,Bookkeeping [book1242]
sich1238,16,16,0,32,Sino-Tibetan [sino1245]
awee1242,2,2,0,4,Afro-Asiatic [afro1255]
pwoe1235,74,74,0,148,Sino-Tibetan [sino1245]
gugu1254,2,2,0,4,Pama-Nyungan [pama1250]
tune1241,2,2,0,4,Bookkeeping [book1242]
kiow1266,10,10,0,20,Kiowa-Tanoan [kiow1265]
coas1295,8,8,0,16,Austronesian [aust1307]
nayi1242,2,2,0,4,Indo-European [indo1319]
norw1262,3,3,0,6,Indo-European [indo1319]
gela1263,2,2,0,4,Austronesian [aust1307]
waur1244,8,8,0,16,Arawakan [araw1281]
sant1424,1,1,0,2,Uto-Aztecan [utoa1244]
loka1252,86,86,0,172,Atlantic-Congo [atla1278]
pitj1243,7,7,0,14,Pama-Nyungan [pama1250]
bata1298,57,57,0,114,Austronesian [aust1307]
hmar1241,5,5,0,10,Sino-Tibetan [sino1245]
hani1248,1,1,0,2,Sino-Tibetan [sino1245]
zoog1238,7,7,0,14,Otomanguean [otom1299]
asho1236,3,3,0,6,Sino-Tibetan [sino1245]
sout2976,4,4,0,8,Uto-Aztecan [utoa1244]
dako1258,2,2,0,4,Siouan [siou1252]
buki1249,16,16,0,32,Nuclear Torricelli [nucl1708]
tika1246,3,3,0,6,Atlantic-Congo [atla1278]
agut1237,107,107,0,214,Austronesian [aust1307]
wall1257,2,2,0,4,Austronesian [aust1307]
clas1250,22,22,0,44,Uto-Aztecan [utoa1244]
wasc1239,2,2,0,4,Chinookan [chin1490]
sgaw1245,2,2,0,4,Sino-Tibetan [sino1245]
muns1251,3,3,0,6,Algic [algi1248]
dari1249,7,7,0,14,Indo-European [indo1319]
abun1252,4,4,0,8,None
kash1280,4,4,0,8,Pomoan [pomo1273]
nuer1246,6,6,0,12,Nilotic [nilo1247]
nusu1239,1,1,0,2,Sino-Tibetan [sino1245]
papa1265,5,5,0,10,Austronesian [aust1307]
boro1282,2,2,0,4,Bororoan [boro1281]
ashe1272,2,2,0,4,Arawakan [araw1281]
wall1238,2,2,0,4,Sahaptian [saha1239]
sham1280,11,11,0,22,Atlantic-Congo [atla1278]
oldp1254,4,4,0,8,Indo-European [indo1319]
wamb1258,49,49,0,98,Mirndi [mirn1241]
hmon1264,4,4,0,8,Hmong-Mien [hmon1336]
dyaa1242,2,2,0,4,Pama-Nyungan [pama1250]
seve1240,1,1,0,2,Algic [algi1248]
jaru1257,7,7,0,14,Bookkeeping [book1242]
tiri1258,1,1,0,2,Austronesian [aust1307]
cham1309,4,4,0,8,Nakh-Daghestanian [nakh1245]
arop1243,17,17,0,34,Austronesian [aust1307]
nort2980,29,29,0,58,Quechuan [quec1387]
uppe1439,2,2,0,4,Salishan [sali1255]
kich1262,24,24,0,48,Mayan [maya1287]
sasa1249,38,38,0,76,Austronesian [aust1307]
nort2810,2,2,0,4,Kru [krua1234]
sand1273,12,12,0,24,None
elna1235,5,5,0,10,Uto-Aztecan [utoa1244]
stra1244,35,35,0,70,Salishan [sali1255]
hata1243,7,7,0,14,Hatam-Mansim [hata1242]
copa1237,8,8,0,16,Otomanguean [otom1299]
east2379,25,25,0,50,Pama-Nyungan [pama1250]
juti1236,1,1,0,2,Indo-European [indo1319]
sout2994,3,3,0,6,Nambiquaran [namb1299]
wano1243,3,3,0,6,Nuclear Trans New Guinea [nucl1709]
cent2127,33,33,0,66,Eskimo-Aleut [eski1264]
nort2957,1,1,0,2,Uto-Aztecan [utoa1244]
waiw1244,2,2,0,4,Cariban [cari1283]
izon1238,61,61,0,122,Ijoid [ijoi1239]
ikpo1238,3,3,0,6,Atlantic-Congo [atla1278]
ngam1265,1,1,0,2,Pama-Nyungan [pama1250]
bosn1245,26,26,0,52,Indo-European [indo1319]
kamo1255,1,1,0,2,Nuclear Trans New Guinea [nucl1709]
umat1237,21,21,0,42,Sahaptian [saha1239]
gasc1241,2,2,0,4,Bookkeeping [book1242]
ekar1243,2,2,0,4,Nuclear Trans New Guinea [nucl1709]
inab1237,2,2,0,4,Austronesian [aust1307]
waja1257,2,2,0,4,Pama-Nyungan [pama1250]
wara1303,10,10,0,20,None
yala1262,12,12,0,24,Pama-Nyungan [pama1250]
chan1313,1,1,0,2,Sino-Tibetan [sino1245]
yuhu1238,2,2,0,4,Naduhup [nada1235]
nisg1240,1,1,0,2,Tsimshian [tsim1258]
gamb1252,1,1,0,2,Atlantic-Congo [atla1278]
sant1451,19,19,0,38,Otomanguean [otom1299]
ahom1240,1,1,0,2,Tai-Kadai [taik1256]
tsha1245,1,1,0,2,Sino-Tibetan [sino1245]
dual1243,8,8,0,16,Atlantic-Congo [atla1278]
oldd1237,14,14,0,28,Indo-European [indo1319]
khan1278,6,6,0,12,Atlantic-Congo [atla1278]
haid1248,3,3,0,6,None
tetu1246,1,1,0,2,Austronesian [aust1307]
tepe1278,2,2,0,4,Uto-Aztecan [utoa1244]
futu1245,2,2,0,4,Austronesian [aust1307]
amer1248,9,9,0,18,Sign Language [sign1238]
sela1260,2,2,0,4,Austronesian [aust1307]
tigr1271,4,4,0,8,Afro-Asiatic [afro1255]
athp1241,2,2,0,4,Sino-Tibetan [sino1245]
tzot1262,39,39,0,78,Bookkeeping [book1242]
svan1243,1,1,0,2,Kartvelian [kart1248]
sawe1240,2,2,0,4,Yawa-Saweru [yawa1259]
tzel1255,527,527,0,1054,Bookkeeping [book1242]
narr1259,2,2,0,4,Pama-Nyungan [pama1250]
east2545,16,16,0,32,Pomoan [pomo1273]
curr1243,3,3,0,6,Arawakan [araw1281]
shes1236,1,1,0,2,Sino-Tibetan [sino1245]
rita1239,2,2,0,4,Pama-Nyungan [pama1250]
khar1287,3,3,0,6,Austroasiatic [aust1305]
hava1248,6,6,0,12,Cochimi-Yuman [coch1271]
veng1238,29,29,0,58,Atlantic-Congo [atla1278]
baou1238,44,44,0,88,Atlantic-Congo [atla1278]
west2599,8,8,0,16,Nuclear Trans New Guinea [nucl1709]
koda1254,1,1,0,2,Austroasiatic [aust1305]
yana1271,1,1,0,2,None
pitt1247,22,22,0,44,Pama-Nyungan [pama1250]
wole1240,6,6,0,12,Austronesian [aust1307]
drun1238,140,140,0,280,Sino-Tibetan [sino1245]
sahu1245,3,3,0,6,North Halmahera [nort2923]
nisi1239,3,3,0,6,Bookkeeping [book1242]
tepo1239,2,2,0,4,Kru [krua1234]
dagb1246,8,8,0,16,Atlantic-Congo [atla1278]
tahl1239,14,14,0,28,Athabaskan-Eyak-Tlingit [atha1245]
jica1244,2,2,0,4,Athabaskan-Eyak-Tlingit [atha1245]
lowe1415,4,4,0,8,Nuclear Trans New Guinea [nucl1709]
west2624,18,18,0,36,Uto-Aztecan [utoa1244]
akhv1239,10,10,0,20,Nakh-Daghestanian [nakh1245]
legb1242,5,5,0,10,Atlantic-Congo [atla1278]
seme1247,2,2,0,4,Austroasiatic [aust1305]
oldh1242,2,2,0,4,Uralic [ural1272]
pint1250,2,2,0,4,Pama-Nyungan [pama1250]
huaa1248,2,2,0,4,Tuu [tuuu1241]
kobo1249,16,16,0,32,Nuclear Trans New Guinea [nucl1709]
pera1256,2,2,0,4,Austronesian [aust1307]
kara1464,1,1,0,2,Turkic [turk1311]
koro1298,13,13,0,26,Atlantic-Congo [atla1278]
kabu1256,9,9,0,18,Indo-European [indo1319]
kako1242,1,1,0,2,Atlantic-Congo [atla1278]
koyr1240,18,18,0,36,Songhay [song1307]
yuro1248,4,4,0,8,Algic [algi1248]
kunj1245,2,2,0,4,Pama-Nyungan [pama1250]
kirm1248,19,19,0,38,Indo-European [indo1319]
yuec1235,361,361,0,722,Sino-Tibetan [sino1245]
arab1267,3,3,0,6,Pama-Nyungan [pama1250]
east2354,1,1,0,2,Sino-Tibetan [sino1245]
luuu1242,1,1,0,2,Tai-Kadai [taik1256]
kera1255,6,6,0,12,Afro-Asiatic [afro1255]
bell1243,25,25,0,50,Salishan [sali1255]
kols1241,3,3,0,6,Indo-European [indo1319]
nyam1271,5,5,0,10,Pama-Nyungan [pama1250]
buri1258,2,2,0,4,Mongolic-Khitan [mong1349]
erit1239,1,1,0,2,Lakes Plain [lake1255]
bani1255,2,2,0,4,Arawakan [araw1281]
vene1258,81,81,0,162,Indo-European [indo1319]
gulf1241,1,1,0,2,Afro-Asiatic [afro1255]
adio1239,3,3,0,6,Atlantic-Congo [atla1278]
aari1238,2,2,0,4,South Omotic [sout2845]
maor1244,8,8,0,16,Atlantic-Congo [atla1278]
tuka1248,30,30,0,60,Austronesian [aust1307]
nung1282,5,5,0,10,Sino-Tibetan [sino1245]
sout2992,1,1,0,2,Quechuan [quec1387]
astu1245,2,2,0,4,Indo-European [indo1319]
sanm1289,17,17,0,34,Quechuan [quec1387]
apal1257,10,10,0,20,Cariban [cari1283]
east2447,2,2,0,4,Austronesian [aust1307]
tewa1260,41,41,0,82,Kiowa-Tanoan [kiow1265]
suku1261,2,2,0,4,Atlantic-Congo [atla1278]
swam1239,7,7,0,14,Algic [algi1248]
trio1238,15,15,0,30,Cariban [cari1283]
haya1250,3,3,0,6,Atlantic-Congo [atla1278]
huba1236,1,1,0,2,Afro-Asiatic [afro1255]
pure1242,7,7,0,14,Tarascan [tara1323]
mina1276,1,1,0,2,Afro-Asiatic [afro1255]
fasu1242,4,4,0,8,None
dama1278,2,2,0,4,Indo-European [indo1319]
pero1241,2,2,0,4,Afro-Asiatic [afro1255]
idom1241,1,1,0,2,Atlantic-Congo [atla1278]
yamp1242,46,46,0,92,Sino-Tibetan [sino1245]
yoyy1238,1,1,0,2,Tai-Kadai [taik1256]
hmon1338,46,46,0,92,Bookkeeping [book1242]
ngar1284,3,3,0,6,Worrorran [worr1236]
bare1276,1,1,0,2,Arawakan [araw1281]
zaba1237,1,1,0,2,Austronesian [aust1307]
khas1269,4,4,0,8,Austroasiatic [aust1305]
bant1281,1,1,0,2,Sino-Tibetan [sino1245]
greb1256,1,1,0,2,Kru [krua1234]
kist1241,4,4,0,8,Afro-Asiatic [afro1255]
cent2128,7,7,0,14,Eskimo-Aleut [eski1264]
cent1990,1,1,0,2,Austroasiatic [aust1305]
ashe1273,5,5,0,10,Arawakan [araw1281]
hiri1237,3,3,0,6,Pidgin [pidg1258]
bori1243,9,9,0,18,Sino-Tibetan [sino1245]
azoy1236,10,10,0,20,Otomanguean [otom1299]
dumi1241,3,3,0,6,Sino-Tibetan [sino1245]
ainu1240,22,22,0,44,Ainu [ainu1252]
sina1266,5,5,0,10,Austronesian [aust1307]
tayo1238,2,2,0,4,Indo-European [indo1319]
slov1269,13,13,0,26,Indo-European [indo1319]
tiwi1244,4,4,0,8,None
chua1250,5,5,0,10,Nuclear Trans New Guinea [nucl1709]
kana1288,2,2,0,4,Dagan [daga1274]
inar1241,17,17,0,34,Uralic [ural1272]
thak1245,1,1,0,2,Sino-Tibetan [sino1245]
yany1243,3,3,0,6,Pama-Nyungan [pama1250]
thay1249,16,16,0,32,Pama-Nyungan [pama1250]
akha1245,5,5,0,10,Sino-Tibetan [sino1245]
diii1241,1,1,0,2,Atlantic-Congo [atla1278]
cata1241,12,12,0,24,Sign Language [sign1238]
fada1250,2,2,0,4,Indo-European [indo1319]
wall1255,1,1,0,2,Indo-European [indo1319]
yaka1269,4,4,0,8,Atlantic-Congo [atla1278]
piji1239,1,1,0,2,Indo-European [indo1319]
gagn1235,3,3,0,6,Kru [krua1234]
nyam1277,4,4,0,8,Atlantic-Congo [atla1278]
peng1244,5,5,0,10,Dravidian [drav1251]
bang1354,2,2,0,4,Atlantic-Congo [atla1278]
garo1247,8,8,0,16,Sino-Tibetan [sino1245]
kinn1249,13,13,0,26,Sino-Tibetan [sino1245]
kron1241,11,11,0,22,Kadugli-Krongo [kadu1256]
tari1263,41,41,0,82,Afro-Asiatic [afro1255]
nung1290,6,6,0,12,Gunwinyguan [gunw1250]
koon1244,12,12,0,24,Atlantic-Congo [atla1278]
kaba1278,87,87,0,174,Abkhaz-Adyge [abkh1242]
tund1254,4,4,0,8,Uralic [ural1272]
gale1259,6,6,0,12,North Halmahera [nort2923]
ngal1293,69,69,0,138,Gunwinyguan [gunw1250]
guar1293,2,2,0,4,Arawakan [araw1281]
yind1247,5,5,0,10,Pama-Nyungan [pama1250]
olut1240,9,9,0,18,Mixe-Zoque [mixe1284]
lama1288,1,1,0,2,Afro-Asiatic [afro1255]
guil1236,144,144,0,288,Otomanguean [otom1299]
wayu1241,1,1,0,2,Sino-Tibetan [sino1245]
jaqa1244,4,4,0,8,Aymaran [ayma1253]
tupu1244,2,2,0,4,Atlantic-Congo [atla1278]
tosk1239,124,124,0,248,Indo-European [indo1319]
tzut1249,1,1,0,2,Bookkeeping [book1242]
chor1273,8,8,0,16,Mayan [maya1287]
sika1262,8,8,0,16,Austronesian [aust1307]
tani1257,2,2,0,4,Tucanoan [tuca1253]
zaiw1241,4,4,0,8,Sino-Tibetan [sino1245]
sanj1284,34,34,0,68,Otomanguean [otom1299]
nort2745,19,19,0,38,Yukaghir [yuka1259]
jaru1254,28,28,0,56,Pama-Nyungan [pama1250]
cent2004,18,18,0,36,Sino-Tibetan [sino1245]
pale1260,2,2,0,4,Indo-European [indo1319]
mezo1235,24,24,0,48,Otomanguean [otom1299]
ixil1253,4,4,0,8,Mayan [maya1287]
khan1273,50,50,0,100,Uralic [ural1272]
bafu1246,1,1,0,2,Atlantic-Congo [atla1278]
gavi1246,1,1,0,2,Tupian [tupi1275]
ngan1295,8,8,0,16,Gunwinyguan [gunw1250]
bodo1267,4,4,0,8,Austroasiatic [aust1305]
loth1237,5,5,0,10,Sino-Tibetan [sino1245]
yidi1250,39,39,0,78,Pama-Nyungan [pama1250]
kuna1268,2,2,0,4,None
goon1238,17,17,0,34,Bunaban [buna1274]
east1436,44,44,0,88,Indo-European [indo1319]
keni1249,398,398,0,796,Austronesian [aust1307]
iaai1238,14,14,0,28,Austronesian [aust1307]
toho1245,68,68,0,136,Uto-Aztecan [utoa1244]
alun1238,4,4,0,8,Austronesian [aust1307]
amah1246,13,13,0,26,Pano-Tacanan [pano1259]
yami1254,151,151,0,302,Austronesian [aust1307]
sema1266,4,4,0,8,Austroasiatic [aust1305]
tama1336,1,1,0,2,Kayagaric [kaya1327]
taki1248,24,24,0,48,Austronesian [aust1307]
fran1260,8,8,0,16,Indo-European [indo1319]
leal1235,17,17,0,34,Otomanguean [otom1299]
mitl1236,10,10,0,20,Otomanguean [otom1299]
nyan1307,9,9,0,18,Atlantic-Congo [atla1278]
yatz1235,2,2,0,4,Otomanguean [otom1299]
ship1254,11,11,0,22,Pano-Tacanan [pano1259]
xibe1242,2,2,0,4,Tungusic [tung1282]
sier1250,42,42,0,84,Otomanguean [otom1299]
chuj1250,2,2,0,4,Mayan [maya1287]
nucl1696,13,13,0,26,Afro-Asiatic [afro1255]
anyi1245,4,4,0,8,Atlantic-Congo [atla1278]
bauc1238,5,5,0,10,Atlantic-Congo [atla1278]
uppe1455,1,1,0,2,Indo-European [indo1319]
marw1260,10,10,0,20,Indo-European [indo1319]
iwai1244,10,10,0,20,Iwaidjan Proper [iwai1246]
west2361,4,4,0,8,Indo-European [indo1319]
nucl1633,3,3,0,6,Nimboranic [nimb1257]
ilok1237,17,17,0,34,Austronesian [aust1307]
kuku1273,1,1,0,2,Pama-Nyungan [pama1250]
ivat1242,8,8,0,16,Austronesian [aust1307]
pedi1238,66,66,0,132,Atlantic-Congo [atla1278]
dera1248,24,24,0,48,Afro-Asiatic [afro1255]
balt1258,2,2,0,4,Sino-Tibetan [sino1245]
nort2994,1,1,0,2,Austronesian [aust1307]
enge1239,1,1,0,2,Atlantic-Congo [atla1278]
krio1252,7,7,0,14,Indo-European [indo1319]
kama1373,19,19,0,38,Tupian [tupi1275]
paez1247,4,4,0,8,None
gily1242,13,13,0,26,Nivkh [nivk1234]
tour1242,8,8,0,16,Mande [mand1469]
urak1238,2,2,0,4,Austronesian [aust1307]
arbe1236,104,104,0,208,Indo-European [indo1319]
afar1241,2,2,0,4,Afro-Asiatic [afro1255]
cube1242,1,1,0,2,Tucanoan [tuca1253]
voti1245,4,4,0,8,Uralic [ural1272]
tuca1252,4,4,0,8,Tucanoan [tuca1253]
tana1290,4,4,0,8,Athabaskan-Eyak-Tlingit [atha1245]
koyr1242,26,26,0,52,Songhay [song1307]
chip1262,10,10,0,20,Uru-Chipaya [uruc1242]
sikk1242,1,1,0,2,Sino-Tibetan [sino1245]
haka1240,65,65,0,130,Sino-Tibetan [sino1245]
awyi1241,1,1,0,2,Border [bord1247]
asha1243,5,5,0,10,Arawakan [araw1281]
jeme1245,3,3,0,6,Kiowa-Tanoan [kiow1265]
carn1240,2,2,0,4,Austroasiatic [aust1305]
ayuu1242,1,1,0,2,Atlantic-Congo [atla1278]
serr1255,2,2,0,4,Uto-Aztecan [utoa1244]
nort2920,1,1,0,2,Nuclear Trans New Guinea [nucl1709]
tasa1240,6,6,0,12,Songhay [song1307]
sout2694,1,1,0,2,Turkic [turk1311]
nort1550,6,6,0,12,Kiowa-Tanoan [kiow1265]
vaii1241,4,4,0,8,Mande [mand1469]
pany1241,15,15,0,30,Pama-Nyungan [pama1250]
nede1245,2,2,0,4,Timor-Alor-Pantar [timo1261]
baur1253,7,7,0,14,Arawakan [araw1281]
ngal1292,47,47,0,94,Gunwinyguan [gunw1250]
gamb1251,1,1,0,2,Worrorran [worr1236]
chir1286,3,3,0,6,Tupian [tupi1275]
sout2649,192,192,0,384,Indo-European [indo1319]
sout3223,60,60,0,120,Bookkeeping [book1242]
kari1311,3,3,0,6,Tupian [tupi1275]
kadi1248,2,2,0,4,Guaicuruan [guai1249]
balk1252,34,34,0,68,Indo-European [indo1319]
vlax1238,3,3,0,6,Indo-European [indo1319]
gahr1239,1,1,0,2,Sino-Tibetan [sino1245]
bagr1243,2,2,0,4,Indo-European [indo1319]
kung1261,6,6,0,12,Kxa [kxaa1236]
kosr1238,7,7,0,14,Austronesian [aust1307]
west2386,2,2,0,4,Indo-European [indo1319]
ewon1239,3,3,0,6,Atlantic-Congo [atla1278]
texi1237,16,16,0,32,Mixe-Zoque [mixe1284]
sera1260,2,2,0,4,Austronesian [aust1307]
andi1255,2,2,0,4,Nakh-Daghestanian [nakh1245]
cadd1256,16,16,0,32,Caddoan [cadd1255]
mara1386,2,2,0,4,Western Daly [west2434]
jadd1243,1,1,0,2,Sino-Tibetan [sino1245]
djam1256,1,1,0,2,Pama-Nyungan [pama1250]
djam1255,2,2,0,4,Mirndi [mirn1241]
ruka1240,13,13,0,26,Austronesian [aust1307]
fiji1243,69,69,0,138,Austronesian [aust1307]
supy1237,7,7,0,14,Atlantic-Congo [atla1278]
tada1238,97,97,0,194,Songhay [song1307]
tedi1235,6,6,0,12,Sino-Tibetan [sino1245]
oloo1241,1,1,0,2,Nuclear Torricelli [nucl1708]
komb1274,14,14,0,28,Nuclear Trans New Guinea [nucl1709]
abkh1244,41,41,0,82,Abkhaz-Adyge [abkh1242]
guma1253,1,1,0,2,Pama-Nyungan [pama1250]
pont1253,8,8,0,16,Indo-European [indo1319]
ejag1239,2,2,0,4,Atlantic-Congo [atla1278]
newa1246,11,11,0,22,Sino-Tibetan [sino1245]
iatm1242,3,3,0,6,Ndu [nduu1242]
yaga1260,5,5,0,10,Nuclear Trans New Guinea [nucl1709]
nort2627,46,46,0,92,Indo-European [indo1319]
juho1239,2,2,0,4,Kxa [kxaa1236]
tete1251,27,27,0,54,Uto-Aztecan [utoa1244]
aona1235,5,5,0,10,Sino-Tibetan [sino1245]
zoro1242,41,41,0,82,Indo-European [indo1319]
west2420,2,2,0,4,Sino-Tibetan [sino1245]
ronj1237,2,2,0,4,Austronesian [aust1307]
bawm1236,7,7,0,14,Sino-Tibetan [sino1245]
nise1244,1,1,0,2,Maiduan [maid1262]
iton1250,58,58,0,116,None
bena1262,9,9,0,18,Atlantic-Congo [atla1278]
reun1238,5,5,0,10,Indo-European [indo1319]
